自己的	自己的
的时候	的时候
有限公司	有限公司
进一步	进一步
委员会	委员会
我们的	我们的
这样的	这样的
是一个	是一个
为什么	为什么
的重要	的重要
的问题	的问题
越来越	越来越
过程中	过程中
的工作	的工作
他们的	他们的
是一种	是一种
习近平	习近平
的发展	的发展
重要的	重要的
一个人	一个人
进行了	进行了
发展的	发展的
的事情	的事情
不同的	不同的
的情况	的情况
疫情防控	疫情防控
工作的	工作的
社会主义	社会主义
互联网	互联网
一定要	一定要
最大的	最大的
孩子们	孩子们
的地方	的地方
很多人	很多人
不知道	不知道
在一起	在一起
就可以	就可以
了一个	了一个
新时代	新时代
的方式	的方式
共产党	共产党
的生活	的生活
俄罗斯	俄罗斯
也可以	也可以
负责人	负责人
的时间	的时间
第一次	第一次
是什么	是什么
之间的	之间的
高质量	高质量
办公室	办公室
孩子的	孩子的
如果你	如果你
生活中	生活中
良好的	良好的
尤其是	尤其是
国务院	国务院
同学们	同学们
让我们	让我们
也就是	也就是
并不是	并不是
更多的	更多的
工作人员	工作人员
问题的	问题的
共和国	共和国
研究生	研究生
中国共产党	中国共产党
中国的	中国的
方面的	方面的
可能会	可能会
大部分	大部分
幼儿园	幼儿园
博物馆	博物馆
并没有	并没有
人民政府	人民政府
的一个	的一个
总书记	总书记
有一个	有一个
公司的	公司的
特别是	特别是
生活的	生活的
志愿者	志愿者
最好的	最好的
消费者	消费者
的影响	的影响
是因为	是因为
也没有	也没有
大多数	大多数
所有的	所有的
的基础	的基础
是不是	是不是
在中国	在中国
不得不	不得不
每个人	每个人
研究所	研究所
副书记	副书记
公众号	公众号
的主要	的主要
副主任	副主任
的同时	的同时
的故事	的故事
有什么	有什么
人民共和国	人民共和国
自治区	自治区
中华人民共和国	中华人民共和国
教育部	教育部
出版社	出版社
平方米	平方米
亿美元	亿美元
这就是	这就是
可以说	可以说
人民币	人民币
提供了	提供了
意味着	意味着
安全生产	安全生产
党支部	党支部
的历史	的历史
的作用	的作用
出现了	出现了
出来的	出来的
每一个	每一个
股份有限公司	股份有限公司
的原因	的原因
第一个	第一个
有很多	有很多
在这里	在这里
实际上	实际上
真正的	真正的
大学生	大学生
人民法院	人民法院
近年来	近年来
学生的	学生的
世界上	世界上
日上午	日上午
等方面	等方面
的精神	的精神
习近平总书记	习近平总书记
研究院	研究院
在这个	在这个
现代化	现代化
二十大	二十大
丰富的	丰富的
青少年	青少年
的人生	的人生
的一种	的一种
更好的	更好的
可能是	可能是
计算机	计算机
的方法	的方法
都可以	都可以
日下午	日下午
的东西	的东西
是中国	是中国
实验室	实验室
北京市	北京市
的朋友	的朋友
带来的	带来的
总经理	总经理
毕业生	毕业生
高质量发展	高质量发展
而不是	而不是
得到了	得到了
中华民族	中华民族
现在的	现在的
看起来	看起来
是非常	是非常
有一些	有一些
的研究	的研究
还可以	还可以
中国特色	中国特色
毛泽东	毛泽东
中国人民	中国人民
的情况下	的情况下
都没有	都没有
感受到	感受到
工作中	工作中
电视剧	电视剧
董事长	董事长
很大的	很大的
乡村振兴	乡村振兴
我们要	我们要
文化的	文化的
很容易	很容易
的能力	的能力
马克思	马克思
国家的	国家的
房地产	房地产
提出了	提出了
很好的	很好的
新能源	新能源
企业的	企业的
图书馆	图书馆
情况下	情况下
的要求	的要求
这也是	这也是
无论是	无论是
和社会	和社会
的第一	的第一
成为了	成为了
贯彻落实	贯彻落实
上一篇	上一篇
广东省	广东省
主要是	主要是
这个问题	这个问题
上海市	上海市
学习教育	学习教育
的感觉	的感觉
以上的	以上的
可以在	可以在
未来的	未来的
也不会	也不会
这句话	这句话
的中国	的中国
的一些	的一些
代表大会	代表大会
党的二十大	党的二十大
活动的	活动的
巨大的	巨大的
那就是	那就是
植物网	植物网
两个人	两个人
中国特色社会主义	中国特色社会主义
了很多	了很多
下一篇	下一篇
市政府	市政府
发动机	发动机
的关系	的关系
联合国	联合国
有时候	有时候
不一样	不一样
我们在	我们在
国家级	国家级
美好的	美好的
新加坡	新加坡
年轻人	年轻人
还没有	还没有
维生素	维生素
加拿大	加拿大
领域的	领域的
的内容	的内容
有没有	有没有
意大利	意大利
都知道	都知道
的基本	的基本
我觉得	我觉得
常委会	常委会
另一方面	另一方面
实现了	实现了
的机会	的机会
科学院	科学院
相关的	相关的
党委书记	党委书记
之所以	之所以
发生了	发生了
党组织	党组织
接下来	接下来
一方面	一方面
地区的	地区的
管理局	管理局
让自己	让自己
小朋友	小朋友
有一种	有一种
市场的	市场的
和其他	和其他
基础设施	基础设施
工作者	工作者
同比增长	同比增长
世界的	世界的
工程师	工程师
的行为	的行为
更好地	更好地
内蒙古	内蒙古
充分发挥	充分发挥
人民群众	人民群众
的设计	的设计
经济发展	经济发展
的世界	的世界
电视台	电视台
第一时间	第一时间
党史学习教育	党史学习教育
副主席	副主席
事实上	事实上
看到了	看到了
师范大学	师范大学
的学生	的学生
获得了	获得了
了一些	了一些
范围内	范围内
公安局	公安局
形成了	形成了
投资者	投资者
大量的	大量的
别人的	别人的
的就是	的就是
一系列	一系列
生态环境	生态环境
不需要	不需要
完成了	完成了
秘书长	秘书长
的发生	的发生
核酸检测	核酸检测
服务中心	服务中心
产品的	产品的
一直在	一直在
也不是	也不是
俱乐部	俱乐部
长时间	长时间
中共中央	中共中央
的孩子	的孩子
志愿服务	志愿服务
取得了	取得了
数字化	数字化
研究中心	研究中心
规定的	规定的
新冠肺炎	新冠肺炎
有效的	有效的
系统的	系统的
基本上	基本上
的过程	的过程
党中央	党中央
在北京	在北京
信息化	信息化
山东省	山东省
的过程中	的过程中
不可能	不可能
的一切	的一切
给大家	给大家
科学家	科学家
党员干部	党员干部
西班牙	西班牙
的事实	的事实
不仅仅	不仅仅
参加了	参加了
你可以	你可以
简单的	简单的
经济社会	经济社会
大数据	大数据
致力于	致力于
的通知	的通知
马克思主义	马克思主义
的学习	的学习
江苏省	江苏省
委員會	委員會
是我们	是我们
的安全	的安全
出现在	出现在
老年人	老年人
开展了	开展了
这一点	这一点
人工智能	人工智能
另一个	另一个
产生的	产生的
糖尿病	糖尿病
的基础上	的基础上
著名的	著名的
教育的	教育的
澳大利	澳大利
浙江省	浙江省
老师的	老师的
没想到	没想到
及以上	及以上
高速公路	高速公路
优秀的	优秀的
项目的	项目的
让孩子	让孩子
的社会	的社会
正确的	正确的
的规定	的规定
更大的	更大的
第二次	第二次
检察院	检察院
有利于	有利于
专业的	专业的
产业链	产业链
相结合	相结合
一定会	一定会
强大的	强大的
使用的	使用的
被称为	被称为
有哪些	有哪些
微信公众号	微信公众号
活动中	活动中
解决方案	解决方案
历史上	历史上
建设的	建设的
我们可以	我们可以
班主任	班主任
让他们	让他们
重要的是	重要的是
主持人	主持人
艺术家	艺术家
澳大利亚	澳大利亚
的力量	的力量
知识产权	知识产权
不错的	不错的
黑龙江	黑龙江
工作室	工作室
多年的	多年的
四川省	四川省
的教育	的教育
的形式	的形式
改革开放	改革开放
事业单位	事业单位
身份证	身份证
关键词	关键词
下一步	下一步
独特的	独特的
解放军	解放军
成功的	成功的
人大常委会	人大常委会
提供的	提供的
结束后	结束后
全世界	全世界
有可能	有可能
应该是	应该是
新技术	新技术
喜欢的	喜欢的
存在的	存在的
可持续	可持续
生命的	生命的
身体健康	身体健康
怎么办	怎么办
乌克兰	乌克兰
中国人	中国人
带来了	带来了
社会的	社会的
机器人	机器人
非常的	非常的
的日子	的日子
最重要的	最重要的
河南省	河南省
分别为	分别为
有一定的	有一定的
达到了	达到了
是为了	是为了
的文化	的文化
运动员	运动员
国内外	国内外
严重的	严重的
价值观	价值观
再加上	再加上
据了解	据了解
的位置	的位置
人生的	人生的
学校的	学校的
同时也	同时也
开发区	开发区
变成了	变成了
的作品	的作品
的需求	的需求
他们在	他们在
的态度	的态度
相应的	相应的
成年人	成年人
国民党	国民党
什么是	什么是
真的是	真的是
的结果	的结果
的企业	的企业
主管部门	主管部门
介绍了	介绍了
全方位	全方位
怎么样	怎么样
自身的	自身的
对自己	对自己
增加了	增加了
给自己	给自己
今天的	今天的
大家都	大家都
产业发展	产业发展
的产品	的产品
可能性	可能性
传统文化	传统文化
发布的	发布的
有助于	有助于
的关键	的关键
人力资源	人力资源
不可避免	不可避免
就没有	就没有
创始人	创始人
当事人	当事人
蛋白质	蛋白质
各项工作	各项工作
科技创新	科技创新
服务的	服务的
了解到	了解到
一个月	一个月
程度上	程度上
一定的	一定的
的女人	的女人
有些人	有些人
数据显示	数据显示
时代的	时代的
分公司	分公司
上市公司	上市公司
把自己	把自己
常见的	常见的
这是一	这是一
组织的	组织的
城市的	城市的
的状态	的状态
有关部门	有关部门
行业的	行业的
科学技术	科学技术
的效果	的效果
的目标	的目标
上半年	上半年
一段时间	一段时间
将继续	将继续
所谓的	所谓的
制造业	制造业
有一天	有一天
的国家	的国家
要注意	要注意
或者是	或者是
其中的	其中的
的相关	的相关
清华大学	清华大学
最后一	最后一
和发展	和发展
段时间	段时间
派出所	派出所
传统的	传统的
这个时候	这个时候
不容易	不容易
下来的	下来的
中医药	中医药
有一定	有一定
公众平台	公众平台
为主题	为主题
的政治	的政治
的核心	的核心
全新的	全新的
建立了	建立了
也不能	也不能
在一个	在一个
也就是说	也就是说
影响力	影响力
不管是	不管是
在美国	在美国
政府的	政府的
为大家	为大家
的信息	的信息
微信公众平台	微信公众平台
给我们	给我们
以下简称	以下简称
中全会	中全会
做什么	做什么
届全国	届全国
特朗普	特朗普
科技有限公司	科技有限公司
第二天	第二天
学习的	学习的
我们会	我们会
在全国	在全国
这件事	这件事
一等奖	一等奖
学习贯彻	学习贯彻
深圳市	深圳市
新华社	新华社
等工作	等工作
一体化	一体化
交通运输	交通运输
篇文章	篇文章
的变化	的变化
一开始	一开始
新中国	新中国
养老金	养老金
伟大的	伟大的
哈尔滨	哈尔滨
为中心	为中心
公安机关	公安机关
越来越多	越来越多
来看看	来看看
的原则	的原则
提高了	提高了
与此同时	与此同时
当时的	当时的
选择了	选择了
的表现	的表现
一带一路	一带一路
的一部分	的一部分
经济学	经济学
能力和	能力和
领导人	领导人
高血压	高血压
健康的	健康的
实际行动	实际行动
奥运会	奥运会
工作会议	工作会议
人员的	人员的
等问题	等问题
的声音	的声音
等方式	等方式
没有任何	没有任何
来源于	来源于
找到了	找到了
人才培养	人才培养
今年的	今年的
河北省	河北省
领导小组	领导小组
老师们	老师们
提出的	提出的
这是一个	这是一个
的技术	的技术
我们就	我们就
大家的	大家的
竞争力	竞争力
合法权益	合法权益
各部门	各部门
法律法规	法律法规
的环境	的环境
离不开	离不开
明显的	明显的
朋友圈	朋友圈
湖南省	湖南省
需要的	需要的
的一年	的一年
意识到	意识到
基础上	基础上
的重要性	的重要性
了自己的	了自己的
的人员	的人员
十四五	十四五
体现了	体现了
来自于	来自于
每一位	每一位
供应链	供应链
的思想	的思想
经历了	经历了
美丽的	美丽的
确诊病例	确诊病例
基金会	基金会
教育局	教育局
造成的	造成的
发布会	发布会
没有人	没有人
研究员	研究员
标准化	标准化
相关部门	相关部门
第二个	第二个
相当于	相当于
这些问题	这些问题
不喜欢	不喜欢
大规模	大规模
产生了	产生了
如果是	如果是
国家和	国家和
为核心	为核心
技术的	技术的
的城市	的城市
场比赛	场比赛
的意思	的意思
的服务	的服务
公务员	公务员
必要的	必要的
自动化	自动化
老百姓	老百姓
什么时候	什么时候
的样子	的样子
残疾人	残疾人
感兴趣	感兴趣
办实事	办实事
稳定的	稳定的
供应商	供应商
一个人的	一个人的
平方公里	平方公里
了自己	了自己
的目的	的目的
部部长	部部长
除此之外	除此之外
我们将	我们将
条件的	条件的
重要讲话	重要讲话
世界杯	世界杯
脱贫攻坚	脱贫攻坚
充满了	充满了
的价格	的价格
了一下	了一下
领导干部	领导干部
毕业于	毕业于
人民的	人民的
人民医院	人民医院
集团有限公司	集团有限公司
工作经验	工作经验
美国的	美国的
人民代表大会	人民代表大会
企业家	企业家
不超过	不超过
以色列	以色列
大学的	大学的
设计师	设计师
社会科学	社会科学
座谈会	座谈会
这两个	这两个
给孩子	给孩子
我认为	我认为
就这样	就这样
了中国	了中国
自行车	自行车
问题的关键	问题的关键
失去了	失去了
一部分	一部分
但如果	但如果
对中国	对中国
女人的	女人的
采用了	采用了
新时代中国特色社会主义	新时代中国特色社会主义
什么样的	什么样的
只不过	只不过
的使用	的使用
历史的	历史的
就已经	就已经
高度重视	高度重视
的支持	的支持
党的十九	党的十九
适用于	适用于
个小时	个小时
为中国	为中国
万美元	万美元
常态化	常态化
的消息	的消息
的成绩	的成绩
广州市	广州市
的风险	的风险
湖北省	湖北省
项目建设	项目建设
成立于	成立于
可以通过	可以通过
完整的	完整的
时间的	时间的
等相关	等相关
患者的	患者的
党组书记	党组书记
党的二十大精神	党的二十大精神
过去的	过去的
开始了	开始了
多年来	多年来
有的人	有的人
处女座	处女座
能力的	能力的
意义的	意义的
该公司	该公司
陕西省	陕西省
已成为	已成为
还有一	还有一
一个个	一个个
发现了	发现了
受到了	受到了
一样的	一样的
二等奖	二等奖
不仅是	不仅是
建筑面积	建筑面积
文化遗产	文化遗产
马来西亚	马来西亚
水瓶座	水瓶座
农产品	农产品
关系的	关系的
小时候	小时候
安徽省	安徽省
副院长	副院长
副局长	副局长
的数据	的数据
没有什么	没有什么
我知道	我知道
分别是	分别是
福建省	福建省
都不会	都不会
第三方	第三方
人们的	人们的
的管理	的管理
的专业	的专业
疫情防控工作	疫情防控工作
会出现	会出现
北京大学	北京大学
每个人都	每个人都
监督管理	监督管理
在我们	在我们
安全的	安全的
不断的	不断的
中小学	中小学
更容易	更容易
的一次	的一次
这个世界	这个世界
朋友们	朋友们
人民检察院	人民检察院
差不多	差不多
建设和	建设和
的功能	的功能
的高度	的高度
发布了	发布了
轨道交通	轨道交通
的角度	的角度
排行榜	排行榜
不断地	不断地
怎样的	怎样的
是一位	是一位
与中国	与中国
所以在	所以在
还需要	还需要
发生的	发生的
办公厅	办公厅
有限责任	有限责任
为进一步	为进一步
背景下	背景下
狮子座	狮子座
的食物	的食物
的责任	的责任
少数民族	少数民族
让学生	让学生
交通安全	交通安全
高等教育	高等教育
了不少	了不少
在上海	在上海
做一个	做一个
为自己	为自己
最高的	最高的
集团公司	集团公司
这时候	这时候
数据库	数据库
新时代中国特色社会主义思想	新时代中国特色社会主义思想
受欢迎	受欢迎
能不能	能不能
的选择	的选择
嫌疑人	嫌疑人
净利润	净利润
出生于	出生于
是怎么	是怎么
看上去	看上去
一般来说	一般来说
在内的	在内的
内心的	内心的
转化为	转化为
的部分	的部分
强烈的	强烈的
在国内	在国内
一句话	一句话
不愿意	不愿意
的时代	的时代
新征程	新征程
及其他	及其他
就是在	就是在
的现象	的现象
疫苗接种	疫苗接种
但是在	但是在
打电话	打电话
引起的	引起的
副校长	副校长
不忘初心	不忘初心
一定是	一定是
毛主席	毛主席
的人物	的人物
忍不住	忍不住
典型的	典型的
深刻的	深刻的
时期的	时期的
万平方米	万平方米
交易所	交易所
习近平新时代中国特色社会主义思想	习近平新时代中国特色社会主义思想
目的是	目的是
经济社会发展	经济社会发展
作为一个	作为一个
即使是	即使是
机动车	机动车
就开始	就开始
男人的	男人的
管理的	管理的
是一個	是一個
的存在	的存在
的出现	的出现
未成年人	未成年人
二维码	二维码
和服务	和服务
积极参与	积极参与
尽可能	尽可能
有限责任公司	有限责任公司
研究的	研究的
市场上	市场上
是可以	是可以
共青团	共青团
出现的	出现的
考虑到	考虑到
的生命	的生命
所有人	所有人
要知道	要知道
心中的	心中的
一辈子	一辈子
年开始	年开始
智能化	智能化
可以说是	可以说是
这样一个	这样一个
火车站	火车站
党委副书记	党委副书记
的名字	的名字
个人的	个人的
文化和	文化和
合理的	合理的
太平洋	太平洋
了起来	了起来
台北市	台北市
期徒刑	期徒刑
在香港	在香港
同样的	同样的
营商环境	营商环境
加强对	加强对
为群众	为群众
科学与	科学与
子公司	子公司
天然气	天然气
的市场	的市场
理工大学	理工大学
副部长	副部长
做出了	做出了
完美的	完美的
云南省	云南省
的家庭	的家庭
在这种	在这种
办事处	办事处
的特点	的特点
是我国	是我国
的前提	的前提
为我们	为我们
重庆市	重庆市
合作伙伴	合作伙伴
土耳其	土耳其
正常的	正常的
医学院	医学院
自然的	自然的
感觉到	感觉到
外交部	外交部
组织开展	组织开展
高新区	高新区
之一的	之一的
教育教学	教育教学
每一次	每一次
有关规定	有关规定
那时候	那时候
就是要	就是要
身体的	身体的
正能量	正能量
比赛中	比赛中
当前位置	当前位置
实践活动	实践活动
形成的	形成的
省政府	省政府
伴随着	伴随着
作为一名	作为一名
不断提升	不断提升
是一家	是一家
真实的	真实的
会导致	会导致
特殊的	特殊的
有一次	有一次
的决定	的决定
没什么	没什么
的活动	的活动
唯一的	唯一的
党组成员	党组成员
比如说	比如说
国家安全	国家安全
必须要	必须要
违法行为	违法行为
纪念馆	纪念馆
很重要	很重要
新冠病毒	新冠病毒
发生在	发生在
设计的	设计的
坚持以	坚持以
管理工作	管理工作
联合会	联合会
原标题	原标题
认识到	认识到
自己在	自己在
新闻网	新闻网
如果没有	如果没有
食品安全	食品安全
领导班子	领导班子
实践中	实践中
是如何	是如何
不断提高	不断提高
背后的	背后的
天蝎座	天蝎座
就不会	就不会
的角色	的角色
安全感	安全感
你知道	你知道
金牛座	金牛座
这一切	这一切
年以来	年以来
蒋介石	蒋介石
之前的	之前的
最多的	最多的
了一种	了一种
事务所	事务所
伟大复兴	伟大复兴
培训班	培训班
的具体	的具体
人大代表	人大代表
被评为	被评为
推出了	推出了
退役军人	退役军人
在全球	在全球
许可证	许可证
遇到了	遇到了
科技大学	科技大学
等多种	等多种
在哪里	在哪里
足够的	足够的
的爱情	的爱情
电影节	电影节
摩羯座	摩羯座
领导下	领导下
发展和	发展和
的建设	的建设
白羊座	白羊座
合作的	合作的
这本书	这本书
理事会	理事会
不符合	不符合
报记者	报记者
告诉你	告诉你
这里的	这里的
娱乐圈	娱乐圈
射手座	射手座
成立了	成立了
就是一个	就是一个
的公司	的公司
都需要	都需要
天津市	天津市
半导体	半导体
当我们	当我们
的一面	的一面
水平的	水平的
双子座	双子座
巨蟹座	巨蟹座
找不到	找不到
特色的	特色的
有多少	有多少
实际情况	实际情况
也非常	也非常
疾病的	疾病的
群众的	群众的
起来的	起来的
组成部分	组成部分
只需要	只需要
葡萄酒	葡萄酒
百分点	百分点
生活中的	生活中的
有机会	有机会
的方向	的方向
真的很	真的很
可以看到	可以看到
石家庄	石家庄
件事情	件事情
觉得自己	觉得自己
消防安全	消防安全
研讨会	研讨会
与其他	与其他
工程学院	工程学院
解决问题	解决问题
我們的	我們的
才知道	才知道
这种情况	这种情况
副会长	副会长
的其他	的其他
责任编辑	责任编辑
可以用	可以用
已经成为	已经成为
的道路	的道路
很多时候	很多时候
一次性	一次性
和中国	和中国
更高的	更高的
下半年	下半年
了许多	了许多
用人单位	用人单位
一个小	一个小
共同体	共同体
的所有	的所有
心理学	心理学
申请人	申请人
提升了	提升了
父母的	父母的
代表团	代表团
金融机构	金融机构
最后的	最后的
那么多	那么多
毕业后	毕业后
留下了	留下了
推出的	推出的
我希望	我希望
展示了	展示了
医疗机构	医疗机构
家协会	家协会
感染者	感染者
的時候	的時候
劳动者	劳动者
微生物	微生物
指挥部	指挥部
学生们	学生们
管理办法	管理办法
幸福的	幸福的
和生活	和生活
注意到	注意到
双鱼座	双鱼座
解决了	解决了
注意力	注意力
为什么要	为什么要
先生的	先生的
各方面	各方面
基督教	基督教
对自己的	对自己的
对方的	对方的
我们也	我们也
次会议	次会议
宣传部	宣传部
甚至是	甚至是
的人才	的人才
电子商务	电子商务
邓小平	邓小平
政治局	政治局
信息技术	信息技术
之日起	之日起
这么多	这么多
特别的	特别的
女性的	女性的
共产党员	共产党员
标志着	标志着
江西省	江西省
中心的	中心的
服务器	服务器
是否有	是否有
个百分点	个百分点
的概念	的概念
的人们	的人们
年中国	年中国
自然资源	自然资源
市场监管	市场监管
第一百	第一百
胡萝卜	胡萝卜
的电影	的电影
免疫力	免疫力
生活在	生活在
新一代	新一代
等情况	等情况
时间内	时间内
山西省	山西省
所在地	所在地
不可避免的	不可避免的
都是一	都是一
为基础	为基础
信用卡	信用卡
被告人	被告人
新媒体	新媒体
安全隐患	安全隐患
所以说	所以说
表现出	表现出
万人次	万人次
注意的是	注意的是
认为是	认为是
组成的	组成的
一直是	一直是
的男人	的男人
值得一提	值得一提
这一次	这一次
的空间	的空间
新发展	新发展
的想法	的想法
的经济	的经济
创造了	创造了
综合性	综合性
上面的	上面的
的国际	的国际
极大的	极大的
短视频	短视频
还是要	还是要
较强的	较强的
这个人	这个人
怎么样的	怎么样的
会不会	会不会
有人说	有人说
一下子	一下子
的艺术	的艺术
电动车	电动车
的项目	的项目
已经是	已经是
到现在	到现在
服务业	服务业
不仅仅是	不仅仅是
农业农村	农业农村
迎来了	迎来了
新能源汽车	新能源汽车
让大家	让大家
的心情	的心情
政策的	政策的
副教授	副教授
或其他	或其他
多少钱	多少钱
看到的	看到的
有期徒刑	有期徒刑
的一项	的一项
内容及	内容及
其实是	其实是
的标准	的标准
最新的	最新的
经济的	经济的
还有一个	还有一个
全日制	全日制
采访时	采访时
爱好者	爱好者
来到了	来到了
里面的	里面的
中国科学院	中国科学院
建设项目	建设项目
发言人	发言人
目前的	目前的
劳动合同	劳动合同
品牌的	品牌的
因为他	因为他
合作社	合作社
党建工作	党建工作
精神和	精神和
纷纷表示	纷纷表示
非常重要的	非常重要的
代表的	代表的
标准的	标准的
历史文化	历史文化
将成为	将成为
较大的	较大的
一会儿	一会儿
如果说	如果说
董事会	董事会
阿拉伯	阿拉伯
因为他们	因为他们
等领域	等领域
其他的	其他的
进入了	进入了
菲律宾	菲律宾
心理健康	心理健康
的健康	的健康
取得的	取得的
混凝土	混凝土
区块链	区块链
过去了	过去了
条件下	条件下
附近的	附近的
用自己的	用自己的
如果有	如果有
称之为	称之为
我相信	我相信
性价比	性价比
运动会	运动会
委员会委员	委员会委员
下一个	下一个
美术馆	美术馆
合适的	合适的
精神的	精神的
了一场	了一场
我自己	我自己
区政府	区政府
熟悉的	熟悉的
不好的	不好的
组织部	组织部
如果不	如果不
党支部书记	党支部书记
我们必须	我们必须
的做法	的做法
专业技术	专业技术
和工作	和工作
先进的	先进的
无人机	无人机
很多的	很多的
来源网络	来源网络
届中国	届中国
被誉为	被誉为
出来了	出来了
奖学金	奖学金
是没有	是没有
教职工	教职工
展现了	展现了
的不同	的不同
主要有	主要有
严格落实	严格落实
之后的	之后的
是一名	是一名
从严治	从严治
都不是	都不是
较高的	较高的
的事业	的事业
特斯拉	特斯拉
复杂的	复杂的
在日本	在日本
身上的	身上的
个人信息	个人信息
希望能	希望能
演唱会	演唱会
他们会	他们会
进行的	进行的
博士学位	博士学位
副总经理	副总经理
开幕式	开幕式
家长们	家长们
是一件	是一件
的价值	的价值
都非常	都非常
博士生	博士生
能够在	能够在
有力的	有力的
的意义	的意义
中华民族伟大复兴	中华民族伟大复兴
职业技术	职业技术
纪录片	纪录片
该项目	该项目
告诉记者	告诉记者
及相关	及相关
一起来	一起来
的合作	的合作
主要的	主要的
困难的	困难的
已经在	已经在
日常生活中	日常生活中
决策部署	决策部署
的理念	的理念
参加会议	参加会议
领导的	领导的
女主角	女主角
总投资	总投资
日常生活	日常生活
需要如何	需要如何
公交车	公交车
各种各	各种各
管理和	管理和
客户端	客户端
心血管	心血管
的感情	的感情
自然科学	自然科学
又会如何	又会如何
示范区	示范区
值得一提的是	值得一提的是
周恩来	周恩来
是一种怎么样的	是一种怎么样的
纪检监察	纪检监察
当地时间	当地时间
是一种怎么样的存在	是一种怎么样的存在
副市长	副市长
本公司	本公司
一个是	一个是
积极性	积极性
科大学	科大学
价值的	价值的
世界各地	世界各地
产业园	产业园
相同的	相同的
身边的	身边的
就必须	就必须
注意事项	注意事项
太多的	太多的
的一天	的一天
所说的	所说的
这样做	这样做
创新创业	创新创业
高新技术	高新技术
而这些	而这些
公共服务	公共服务
目的地	目的地
传感器	传感器
千万不要	千万不要
有不少	有不少
指导下	指导下
族自治	族自治
的心态	的心态
第一位	第一位
实施方案	实施方案
的文章	的文章
这不是	这不是
时间为	时间为
吸引了	吸引了
的味道	的味道
从一个	从一个
也需要	也需要
的患者	的患者
公司在	公司在
的良好	的良好
人民日报	人民日报
的代表	的代表
许多人	许多人
似乎是一种	似乎是一种
高等学校	高等学校
工作报告	工作报告
越来越多的	越来越多的
重点工作	重点工作
告诉我	告诉我
等方面的	等方面的
家庭的	家庭的
国际机场	国际机场
带领下	带领下
普通人	普通人
图片均	图片均
年以上	年以上
联系电话	联系电话
非常有	非常有
的话题	的话题
物联网	物联网
三等奖	三等奖
文物保护	文物保护
第三次	第三次
奠定了	奠定了
干部职工	干部职工
生产经营	生产经营
又一次	又一次
任何人	任何人
垃圾分类	垃圾分类
上世纪	上世纪
会影响	会影响
小小的	小小的
可持续发展	可持续发展
规范化	规范化
和管理	和管理
和个人	和个人
支付宝	支付宝
候选人	候选人
只要有	只要有
三个月	三个月
结束了	结束了
原因是	原因是
呈现出	呈现出
高水平	高水平
在学校	在学校
截至目前	截至目前
举办的	举办的
的照片	的照片
充分利用	充分利用
的理解	的理解
有效地	有效地
也不要	也不要
把自己的	把自己的
社会主义现代化	社会主义现代化
关注的	关注的
以来的	以来的
化合物	化合物
引起了	引起了
刚开始	刚开始
的知识	的知识
中小企业	中小企业
类型的	类型的
的教学	的教学
的速度	的速度
另一半	另一半
讲述了	讲述了
通过了	通过了
小伙伴	小伙伴
阿里巴巴	阿里巴巴
国际化	国际化
局局长	局局长
留学生	留学生
辽宁省	辽宁省
网络安全	网络安全
航空公司	航空公司
举行的	举行的
不得不面对	不得不面对
莫斯科	莫斯科
通讯员	通讯员
用户的	用户的
在今年	在今年
第十二	第十二
生活方式	生活方式
保护区	保护区
出色的	出色的
系列活动	系列活动
的大型	的大型
一般的	一般的
博物館	博物館
圖書館	圖書館
绝大多数	绝大多数
很可能	很可能
的可能性	的可能性
冠状病毒	冠状病毒
每个人的	每个人的
的来说	的来说
天秤座	天秤座
的人民	的人民
辅导员	辅导员
感受到了	感受到了
思想政治	思想政治
都是在	都是在
贵州省	贵州省
了一定的	了一定的
要求的	要求的
确定的	确定的
看不到	看不到
增强了	增强了
东南亚	东南亚
环境保护	环境保护
多元化	多元化
导致的	导致的
主义的	主义的
想不到	想不到
驾驶员	驾驶员
其他人	其他人
机构的	机构的
其中包括	其中包括
硕士研究生	硕士研究生
行为的	行为的
他人的	他人的
的主题	的主题
卫生健康	卫生健康
和技术	和技术
第十三	第十三
复印件	复印件
内容及图片均	内容及图片均
制度的	制度的
得不到	得不到
表现为	表现为
你自己	你自己
硕士学位	硕士学位
为国家	为国家
日活动	日活动
本文内容及图片均	本文内容及图片均
生产的	生产的
单位的	单位的
条规定	条规定
本文内容及图片均来源网络	本文内容及图片均来源网络
学习了	学习了
政协委员	政协委员
属于自己的	属于自己的
他表示	他表示
的人群	的人群
与发展	与发展
行政区	行政区
在未来	在未来
取决于	取决于
基金會	基金會
公积金	公积金
第一名	第一名
很简单	很简单
原来的	原来的
幸福感	幸福感
的说法	的说法
月中旬	月中旬
职业教育	职业教育
最高人民法院	最高人民法院
也不知道	也不知道
理想信念	理想信念
可以看出	可以看出
公布的	公布的
专注于	专注于
只有一	只有一
的比例	的比例
伊斯兰	伊斯兰
比特币	比特币
队伍建设	队伍建设
体现在	体现在
一直以来	一直以来
本次活动	本次活动
荣誉称号	荣誉称号
在这一	在这一
管理人员	管理人员
具体的	具体的
。。。	。。。
为了让	为了让
销售额	销售额
的传统	的传统
的一生	的一生
出租车	出租车
全力以赴	全力以赴
成都市	成都市
在自己	在自己
和支持	和支持
第一批	第一批
墨西哥	墨西哥
交通大学	交通大学
加入了	加入了
第二届	第二届
市委书记	市委书记
民法典	民法典
知识的	知识的
演唱會	演唱會
的成功	的成功
学习和	学习和
我们都	我们都
不可以	不可以
医护人员	医护人员
進一步	進一步
要坚持	要坚持
如果您	如果您
为人民	为人民
共同努力	共同努力
他们是	他们是
在他的	在他的
对我们	对我们
养老保险	养老保险
从来没有	从来没有
的最大	的最大
传染病	传染病
的优势	的优势
亲爱的	亲爱的
该如何	该如何
科学研究	科学研究
企业和	企业和
公元前	公元前
集中在	集中在
联系人	联系人
第十四	第十四
离开了	离开了
明白了	明白了
及以上学历	及以上学历
媒体报道	媒体报道
甲状腺	甲状腺
了一系列	了一系列
普通的	普通的
进一步加强	进一步加强
医科大学	医科大学
处理器	处理器
可爱的	可爱的
财政部	财政部
共产党的	共产党的
等多个	等多个
公布了	公布了
指的是	指的是
举行了	举行了
在国际	在国际
了解了	了解了
你们的	你们的
党代会	党代会
吸引力	吸引力
的法律	的法律
增值税	增值税
我个人	我个人
吉林省	吉林省
发改委	发改委
精彩的	精彩的
年前的	年前的
管委会	管委会
造成了	造成了
出席会议	出席会议
使用者	使用者
尤其是在	尤其是在
没有了	没有了
请联系	请联系
信息的	信息的
交通事故	交通事故
更重要的是	更重要的是
作出了	作出了
地方政府	地方政府
研究会	研究会
自己是	自己是
日报道	日报道
一个女人	一个女人
的同学	的同学
对我的	对我的
的意见	的意见
为群众办实事	为群众办实事
男主角	男主角
年轻的	年轻的
的重大	的重大
理事长	理事长
生态文明	生态文明
应用于	应用于
白癜风	白癜风
接下来的	接下来的
新冠肺炎疫情	新冠肺炎疫情
外国语	外国语
开发商	开发商
学生会	学生会
的努力	的努力
程度的	程度的
爸爸妈妈	爸爸妈妈
另一种	另一种
加快推进	加快推进
這樣的	這樣的
赢得了	赢得了
改变了	改变了
市人民政府	市人民政府
宣传活动	宣传活动
知道了	知道了
也是一个	也是一个
稳定性	稳定性
黑龙江省	黑龙江省
爱国主义	爱国主义
你怎么	你怎么
甘肃省	甘肃省
党总支	党总支
要加强	要加强
不一样的	不一样的
非常好	非常好
责任心	责任心
给他们	给他们
不存在	不存在
最重要	最重要
几个月	几个月
完全是	完全是
比上年	比上年
很强的	很强的
很多人都	很多人都
技术和	技术和
常务委员会	常务委员会
日本的	日本的
二十四	二十四
家庭教育	家庭教育
成为一个	成为一个
事业发展	事业发展
已经有	已经有
的身份	的身份
这意味着	这意味着
内容的	内容的
在接受	在接受
是比较	是比较
全国各地	全国各地
时间和	时间和
氧化碳	氧化碳
智能手机	智能手机
建设工程	建设工程
的语言	的语言
所以我	所以我
消费者的	消费者的
家里的	家里的
抗日战争	抗日战争
市公安局	市公安局
即便是	即便是
县政府	县政府
为契机	为契机
為什麼	為什麼
实在是	实在是
在我国	在我国
在工作	在工作
主演的	主演的
全面从严治	全面从严治
副总裁	副总裁
已经被	已经被
小程序	小程序
市中心	市中心
爱情的	爱情的
我们需要	我们需要
超过了	超过了
广播电视	广播电视
的政策	的政策
女朋友	女朋友
了一次	了一次
管理制度	管理制度
半小时	半小时
就需要	就需要
不确定	不确定
了我的	了我的
平台的	平台的
教育和	教育和
安全性	安全性
希望大家	希望大家
人类的	人类的
不一定	不一定
转型升级	转型升级
在家里	在家里
的热情	的热情
责任感	责任感
同一个	同一个
都必须	都必须
商学院	商学院
明确了	明确了
迪士尼	迪士尼
应该如何	应该如何
百分之	百分之
党和国家	党和国家
葡萄牙	葡萄牙
中全会精神	中全会精神
犯罪嫌疑人	犯罪嫌疑人
意识形态	意识形态
我们一起	我们一起
大自然	大自然
适当的	适当的
我们是	我们是
全覆盖	全覆盖
管理部门	管理部门
基本的	基本的
运营商	运营商
叙利亚	叙利亚
意识和	意识和
很高的	很高的
以至于	以至于
社会组织	社会组织
再一次	再一次
的前提下	的前提下
丰富多彩	丰富多彩
的生产	的生产
十八大	十八大
征求意见	征求意见
战略合作	战略合作
因为我	因为我
严格按照	严格按照
做到了	做到了
阿富汗	阿富汗
总面积	总面积
坚定不移	坚定不移
也比较	也比较
然后再	然后再
了下来	了下来
都不能	都不能
以下的	以下的
进出口	进出口
关键是	关键是
结合起来	结合起来
无症状	无症状
了一份	了一份
各单位	各单位
十三五	十三五
音乐会	音乐会
北京时间	北京时间
如果我们	如果我们
深入开展	深入开展
义务教育	义务教育
角度来看	角度来看
民族团结	民族团结
经过了	经过了
新冠疫情	新冠疫情
联系方式	联系方式
却没有	却没有
作品的	作品的
科学的	科学的
的美好	的美好
全过程	全过程
者优先	者优先
这些人	这些人
众所周	众所周
功能的	功能的
告诉我们	告诉我们
通过对	通过对
环境的	环境的
爱的人	爱的人
是国家	是国家
就可以了	就可以了
有两个	有两个
的最佳	的最佳
中国经济	中国经济
完成的	完成的
会议上	会议上
杭州市	杭州市
的女性	的女性
男朋友	男朋友
我没有	我没有
激烈的	激烈的
劳动力	劳动力
发展战略	发展战略
本科生	本科生
目前已	目前已
说什么	说什么
我们对	我们对
生物学	生物学
行政处罚	行政处罚
形式的	形式的
会议室	会议室
这一年	这一年
工程建设	工程建设
起来了	起来了
行政部门	行政部门
但由于	但由于
如今的	如今的
会议精神	会议精神
的有效	的有效
举办了	举办了
代表着	代表着
和文化	和文化
党的十九届	党的十九届
经销商	经销商
变得更加	变得更加
节假日	节假日
还有很多	还有很多
原材料	原材料
公共卫生	公共卫生
太阳能	太阳能
为实现	为实现
而且还	而且还
一点点	一点点
由中国	由中国
工作和	工作和
接受了	接受了
占地面积	占地面积
党工委	党工委
存在着	存在着
冬奥会	冬奥会
成长的	成长的
桃花运	桃花运
长三角	长三角
一定程度上	一定程度上
农民工	农民工
我可以	我可以
相关负责人	相关负责人
社会保障	社会保障
中国共产党成立	中国共产党成立
此次活动	此次活动
摩托车	摩托车
积极的	积极的
的一份	的一份
他认为	他认为
不只是	不只是
在网上	在网上
的功效	的功效
香港的	香港的
为核心的	为核心的
他們的	他們的
首先要	首先要
或者说	或者说
孩子们的	孩子们的
年全国	年全国
只是一	只是一
发展规划	发展规划
更多信息	更多信息
发现的	发现的
变速箱	变速箱
面临的	面临的
影响到	影响到
为企业	为企业
两个月	两个月
和国家	和国家
的认识	的认识
诺贝尔	诺贝尔
可以让	可以让
按规定	按规定
党风廉政	党风廉政
向上的	向上的
快速发展	快速发展
了一条	了一条
反映了	反映了
有趣的	有趣的
经历过	经历过
民主党	民主党
回到了	回到了
也可能	也可能
博士后	博士后
并不能	并不能
队员们	队员们
因为它	因为它
新材料	新材料
服务平台	服务平台
的形象	的形象
资本主义	资本主义
为主要	为主要
主体责任	主体责任
因为在	因为在
慎重的	慎重的
这些都是	这些都是
和孩子	和孩子
全社会	全社会
野生动物	野生动物
公开招聘	公开招聘
华盛顿	华盛顿
非物质	非物质
教师的	教师的
日本人	日本人
宣传教育	宣传教育
当年的	当年的
高风险	高风险
在自己的	在自己的
所得税	所得税
成熟的	成熟的
他们对	他们对
管理学院	管理学院
的权利	的权利
决定了	决定了
日正式	日正式
在生活中	在生活中
制定了	制定了
积极开展	积极开展
不小心	不小心
停车场	停车场
不应该	不应该
留下的	留下的
胆固醇	胆固醇
新一轮	新一轮
中科院	中科院
跟党走	跟党走
之间的关系	之间的关系
的投资	的投资
一家人	一家人
记者从	记者从
得到的	得到的
人民网	人民网
违法犯罪	违法犯罪
不合格	不合格
一个新的	一个新的
没办法	没办法
女孩子	女孩子
图片来源	图片来源
改革的	改革的
生活会	生活会
我国的	我国的
日消息	日消息
最美的	最美的
每一个人	每一个人
并通过	并通过
才发现	才发现
共产主义	共产主义
设备的	设备的
使用了	使用了
前列腺	前列腺
合伙人	合伙人
旗下的	旗下的
职业技术学院	职业技术学院
才能够	才能够
投入到	投入到
为他们	为他们
平台上	平台上
舞台上	舞台上
有许多	有许多
党委委员	党委委员
作出的	作出的
今年以来	今年以来
各种各样的	各种各样的
保持着	保持着
和大家	和大家
的各种	的各种
我们应该	我们应该
村干部	村干部
巴基斯坦	巴基斯坦
独立的	独立的
工业大学	工业大学
准备好	准备好
我已经	我已经
疫情期间	疫情期间
众所周知	众所周知
一年的	一年的
博览会	博览会
重点实验室	重点实验室
安全管理	安全管理
思想和	思想和
更名为	更名为
化妆品	化妆品
抓住了	抓住了
新中国成立	新中国成立
知识和	知识和
高标准	高标准
建立健全	建立健全
的身影	的身影
还是很	还是很
的真实	的真实
万亿元	万亿元
的应用	的应用
问题时	问题时
普通话	普通话
干什么	干什么
我现在	我现在
羽毛球	羽毛球
本赛季	本赛季
不同于	不同于
岗位上	岗位上
证监会	证监会
第一步	第一步
的增长	的增长
日凌晨	日凌晨
剩下的	剩下的
乌鲁木齐	乌鲁木齐
重要作用	重要作用
明确的	明确的
充分的	充分的
它们的	它们的
等活动	等活动
亚马逊	亚马逊
运动的	运动的
都会有	都会有
副秘书长	副秘书长
可以帮助	可以帮助
思考这个问题	思考这个问题
在那里	在那里
就是这样	就是这样
律师事务所	律师事务所
零部件	零部件
经济增长	经济增长
纪委监委	纪委监委
安排部署	安排部署
的一大	的一大
第十五	第十五
学生在	学生在
存在的问题	存在的问题
在感情	在感情
的性格	的性格
知名度	知名度
影响的	影响的
全球化	全球化
内分泌	内分泌
全面的	全面的
让我们一起	让我们一起
漂亮的	漂亮的
总工会	总工会
业务的	业务的
成立的	成立的
同时也是	同时也是
对他们	对他们
高品质	高品质
个性化	个性化
完善的	完善的
不过是	不过是
小朋友们	小朋友们
业有限公司	业有限公司
牢记使命	牢记使命
人体的	人体的
的土地	的土地
研究人员	研究人员
中央军委	中央军委
可以选择	可以选择
能力强	能力强
性疾病	性疾病
起到了	起到了
奋斗目标	奋斗目标
只要你	只要你
过程中的	过程中的
全面推进	全面推进
乒乓球	乒乓球
世界上最	世界上最
建筑物	建筑物
出生的	出生的
展现出	展现出
事业的	事业的
产业化	产业化
紧紧围绕	紧紧围绕
音乐学院	音乐学院
负责同志	负责同志
每一天	每一天
情况的	情况的
主题活动	主题活动
参加工作	参加工作
说过一句	说过一句
最重要的是	最重要的是
人们对	人们对
教育厅	教育厅
的治疗	的治疗
监督管理局	监督管理局
时间里	时间里
技术创新	技术创新
特别是在	特别是在
的心理	的心理
和信息化	和信息化
适量的	适量的
部门的	部门的
不低于	不低于
较好的	较好的
获得者	获得者
不再是	不再是
的音乐	的音乐
主要包括	主要包括
也无法	也无法
我为群众办实事	我为群众办实事
城乡建设	城乡建设
岁以下	岁以下
全体党员	全体党员
是一部	是一部
非物质文化遗产	非物质文化遗产
突出的	突出的
新西兰	新西兰
进一步提升	进一步提升
多样性	多样性
特有的	特有的
习近平总书记在	习近平总书记在
开启了	开启了
海南省	海南省
流行的	流行的
思想的	思想的
的需要	的需要
研究成果	研究成果
左右的	左右的
我喜欢	我喜欢
专业化	专业化
这样的人	这样的人
企业在	企业在
藝術家	藝術家
的情绪	的情绪
研究和	研究和
武汉市	武汉市
复旦大学	复旦大学
深入推进	深入推进
我一直	我一直
召开了	召开了
高雄市	高雄市
新型冠状病毒	新型冠状病毒
的战略	的战略
等内容	等内容
非常重要	非常重要
等症状	等症状
是自己	是自己
学会了	学会了
中的一	中的一
卫生院	卫生院
很快就	很快就
不少人	不少人
全面从严治党	全面从严治党
等因素	等因素
的情形	的情形
这款车	这款车
是一款	是一款
等形式	等形式
在过去	在过去
立方米	立方米
也是一种	也是一种
第一款	第一款
近几年	近几年
慢慢地	慢慢地
市委常委	市委常委
正是因为	正是因为
地理位置	地理位置
领导和	领导和
艺术的	艺术的
始终坚持	始终坚持
当地的	当地的
这才是	这才是
可能的	可能的
报道称	报道称
家人的	家人的
之目的	之目的
马拉松	马拉松
提到的	提到的
是真的	是真的
分之一	分之一
想要的	想要的
对外开放	对外开放
重要讲话精神	重要讲话精神
满意度	满意度
的经验	的经验
需求的	需求的
美术学院	美术学院
比亚迪	比亚迪
脑血管	脑血管
营业收入	营业收入
中国人民解放军	中国人民解放军
红十字	红十字
有一位	有一位
是通过	是通过
才可以	才可以
文明的	文明的
回来了	回来了
认真学习	认真学习
所需的	所需的
的一点	的一点
可谓是	可谓是
過程中	過程中
有关的	有关的
但我们	但我们
快乐的	快乐的
从业人员	从业人员
表达了	表达了
朋友的	朋友的
常用的	常用的
错误的	错误的
坚定的	坚定的
体系建设	体系建设
肯定是	肯定是
也因此	也因此
创新发展	创新发展
会计师	会计师
经营者	经营者
自动驾驶	自动驾驶
的情況	的情況
因为你	因为你
十二条	十二条
怎么做	怎么做
文化旅游	文化旅游
促进了	促进了
阿根廷	阿根廷
为主题的	为主题的
银行卡	银行卡
公共交通	公共交通
不知不觉	不知不觉
如果在	如果在
摄像头	摄像头
个国家	个国家
资源的	资源的
小时内	小时内
党的十九大	党的十九大
村委会	村委会
的自然	的自然
丝绸之路	丝绸之路
课堂教学	课堂教学
等一系列	等一系列
产阶级	产阶级
干细胞	干细胞
的习惯	的习惯
操作系统	操作系统
直辖市	直辖市
国有企业	国有企业
高科技	高科技
一个非常	一个非常
但他们	但他们
每个月	每个月
深入学习贯彻	深入学习贯彻
面临着	面临着
学党史	学党史
奥斯卡	奥斯卡
融合发展	融合发展
中新网	中新网
俗话说	俗话说
还是在	还是在
是出于	是出于
的事物	的事物
综合征	综合征
并不会	并不会
与社会	与社会
事件的	事件的
健康发展	健康发展
主持会议	主持会议
生产线	生产线
好莱坞	好莱坞
他自己	他自己
打造的	打造的
制造商	制造商
打底裤	打底裤
那个时候	那个时候
而发生	而发生
的一位	的一位
受害者	受害者
第十一	第十一
特定的	特定的
文化交流	文化交流
就不能	就不能
白色的	白色的
严格的	严格的
做一些	做一些
以外的	以外的
呼吸道	呼吸道
自我的	自我的
环境中	环境中
老师和	老师和
副作用	副作用
红色基因	红色基因
春节期间	春节期间
侵犯了	侵犯了
并发症	并发症
或者其他	或者其他
柬埔寨	柬埔寨
排名第	排名第
的人口	的人口
大家在	大家在
相对于	相对于
更多的是	更多的是
一生的	一生的
本身的	本身的
保险公司	保险公司
安全和	安全和
很喜欢	很喜欢
着自己的	着自己的
有自己的	有自己的
只有一个	只有一个
科技成果	科技成果
温暖的	温暖的
县公安局	县公安局
到底是	到底是
详细的	详细的
等部门	等部门
阶段的	阶段的
一切都	一切都
是一场	是一场
所在的	所在的
您可以	您可以
只有在	只有在
最大限度	最大限度
就像是	就像是
了出来	了出来
李克强	李克强
每年的	每年的
拥有的	拥有的
只是一个	只是一个
无症状感染者	无症状感染者
的对象	的对象
前所未	前所未
古老的	古老的
慢慢的	慢慢的
收益率	收益率
医疗器械	医疗器械
不允许	不允许
在每个	在每个
胜利召开	胜利召开
班子成员	班子成员
工程技术	工程技术
时时彩	时时彩
监督检查	监督检查
西安市	西安市
行政执法	行政执法
往往是	往往是
专项行动	专项行动
遇到的	遇到的
红色的	红色的
支持和	支持和
曾经的	曾经的
深入学习	深入学习
总决赛	总决赛
了他的	了他的
进一步提高	进一步提高
的事件	的事件
的重要组成部分	的重要组成部分
了解一下	了解一下
在他们	在他们
祖国的	祖国的
多年前	多年前
环境下	环境下
可通过	可通过
行政區	行政區
第三届	第三届
国家队	国家队
不可思	不可思
理想的	理想的
分数线	分数线
最早的	最早的
这一天	这一天
的身体	的身体
不舒服	不舒服
参与者	参与者
也开始	也开始
更多人	更多人
国民经济	国民经济
以实际行动	以实际行动
大湾区	大湾区
流动性	流动性
充分肯定	充分肯定
了一批	了一批
管理有限公司	管理有限公司
的重点	的重点
一个男人	一个男人
到最后	到最后
一年级	一年级
些什么	些什么
的工作人员	的工作人员
出一个	出一个
获得的	获得的
第三个	第三个
通知书	通知书
体制改革	体制改革
材料的	材料的
在我的	在我的
主题党	主题党
在世界	在世界
是目前	是目前
民族的	民族的
已经开始	已经开始
后台留言	后台留言
为主的	为主的
中国梦	中国梦
影响了	影响了
整个人	整个人
下一代	下一代
根据地	根据地
的品牌	的品牌
已完成	已完成
红楼梦	红楼梦
的可能	的可能
这是因为	这是因为
的一致	的一致
大城市	大城市
但其实	但其实
全面建设	全面建设
志愿者们	志愿者们
创作的	创作的
这是一种	这是一种
以上学历	以上学历
和他的	和他的
对孩子	对孩子
重大的	重大的
陌生人	陌生人
月下旬	月下旬
在学习	在学习
大家庭	大家庭
一季度	一季度
金融服务	金融服务
从这个	从这个
和自己	和自己
必不可	必不可
就知道	就知道
资本市场	资本市场
习近平同志	习近平同志
体内的	体内的
的人都	的人都
给予了	给予了
有能力	有能力
的儿子	的儿子
所以我们	所以我们
五花肉	五花肉
数据的	数据的
中央电视台	中央电视台
中共党员	中共党员
全面发展	全面发展
伊拉克	伊拉克
不适合	不适合
应有的	应有的
还有一些	还有一些
主办的	主办的
浏览器	浏览器
发布会上	发布会上
下面的	下面的
而来的	而来的
学院的	学院的
的游戏	的游戏
就好了	就好了
著作权	著作权
中華民國	中華民國
有一点	有一点
这三个	这三个
医院的	医院的
发表了	发表了
质量和	质量和
十三条	十三条
为指导	为指导
中心主任	中心主任
全面提升	全面提升
我不知道	我不知道
的魅力	的魅力
文化艺术	文化艺术
做的事情	做的事情
并讲话	并讲话
第一届	第一届
发挥了	发挥了
的问题是	的问题是
人死亡	人死亡
之类的	之类的
林匹克	林匹克
道路上	道路上
不代表	不代表
心理咨询	心理咨询
的問題	的問題
严格执行	严格执行
好消息	好消息
每天都	每天都
污水处理	污水处理
组委会	组委会
不会有	不会有
核心价值观	核心价值观
的组织	的组织
孙中山	孙中山
的平台	的平台
客户提供	客户提供
旅行社	旅行社
都已经	都已经
经典的	经典的
会产生	会产生
研究室	研究室
其中有	其中有
体会到	体会到
专业知识	专业知识
发展改革	发展改革
医疗卫生	医疗卫生
篇小说	篇小说
以及其他	以及其他
气候变化	气候变化
并同时	并同时
办公室主任	办公室主任
教育基地	教育基地
第一部	第一部
部主任	部主任
政法委	政法委
的小伙伴	的小伙伴
工作组	工作组
参与了	参与了
摄影师	摄影师
父亲的	父亲的
请立即	请立即
管理体系	管理体系
南京市	南京市
工作领导小组	工作领导小组
现有的	现有的
客户的	客户的
意义重大	意义重大
外国人	外国人
竞争对手	竞争对手
习近平总书记关于	习近平总书记关于
分子量	分子量
医疗保险	医疗保险
几十年	几十年
公安部	公安部
广泛的	广泛的
值得注意的是	值得注意的是
的任务	的任务
其实就是	其实就是
涉及到	涉及到
司令员	司令员
集装箱	集装箱
不仅可以	不仅可以
问题上	问题上
还是比较	还是比较
第一天	第一天
统计局	统计局
胡椒粉	胡椒粉
有一個	有一個
这样才能	这样才能
商业银行	商业银行
企业发展	企业发展
得益于	得益于
新闻发布会	新闻发布会
市场化	市场化
意义上	意义上
满满的	满满的
一件事	一件事
统一的	统一的
县级以上	县级以上
是世界	是世界
笔记本	笔记本
人居环境	人居环境
文明实践	文明实践
而对于	而对于
着自己	着自己
佩戴口罩	佩戴口罩
云计算	云计算
首先是	首先是
老干部	老干部
中国社会	中国社会
不是很	不是很
还是会	还是会
帮助下	帮助下
制作的	制作的
数字经济	数字经济
分享了	分享了
多功能	多功能
可以这样	可以这样
里程碑	里程碑
大会上	大会上
革命的	革命的
理论学习	理论学习
万元的	万元的
影响力的	影响力的
越来越好	越来越好
郑州市	郑州市
党建引领	党建引领
教育整顿	教育整顿
向社会	向社会
就不得不	就不得不
他们也	他们也
卫生间	卫生间
和建议	和建议
大家好	大家好
收到了	收到了
中国政府	中国政府
人口的	人口的
区域内	区域内
十四条	十四条
发布时间	发布时间
血液循环	血液循环
日开始	日开始
的大小	的大小
的情感	的情感
委员会主任	委员会主任
意思是	意思是
不清楚	不清楚
元宇宙	元宇宙
为目标	为目标
产业的	产业的
获得感	获得感
你会发现	你会发现
吃苦耐劳	吃苦耐劳
国家主席	国家主席
是一次	是一次
教师资格	教师资格
不少于	不少于
降低了	降低了
看不见	看不见
上一条	上一条
家企业	家企业
碳中和	碳中和
后来的	后来的
将自己	将自己
美国人	美国人
经开区	经开区
健康成长	健康成长
保驾护航	保驾护航
是一座	是一座
公里的	公里的
在这些	在这些
特別行政區	特別行政區
年上半年	年上半年
喜欢的人	喜欢的人
以前的	以前的
情况进行	情况进行
就应该	就应该
重点项目	重点项目
电影的	电影的
小学生	小学生
优异成绩	优异成绩
的根本	的根本
基层党组织	基层党组织
这篇文章	这篇文章
检察机关	检察机关
工作日	工作日
教育活动	教育活动
孩子在	孩子在
局副局长	局副局长
充足的	充足的
分钟后	分钟后
为一体	为一体
加入中国共产党	加入中国共产党
很好地	很好地
博士生导师	博士生导师
和国际	和国际
深厚的	深厚的
任何一个	任何一个
往往会	往往会
不仅如此	不仅如此
年代的	年代的
工程院	工程院
而且在	而且在
社交媒体	社交媒体
接种疫苗	接种疫苗
洛杉矶	洛杉矶
二氧化碳	二氧化碳
美联储	美联储
詹姆斯	詹姆斯
对不起	对不起
建立起	建立起
招商引资	招商引资
知道自己	知道自己
风景区	风景区
就算是	就算是
管理者	管理者
深思熟	深思熟
拥有一	拥有一
经验的	经验的
博物院	博物院
管理中心	管理中心
职业生涯	职业生涯
政治站位	政治站位
大多数人	大多数人
一起去	一起去
我不是	我不是
是需要	是需要
新冠疫苗	新冠疫苗
着一个	着一个
综合素质	综合素质
这件事情	这件事情
观众的	观众的
辦公室	辦公室
原有的	原有的
的父亲	的父亲
科技进步	科技进步
中国古代	中国古代
农业大学	农业大学
十一条	十一条
一步步	一步步
用实际行动	用实际行动
的大力	的大力
犯罪的	犯罪的
之間的	之間的
的经历	的经历
有网友	有网友
师范学院	师范学院
牛仔裤	牛仔裤
节目中	节目中
县委书记	县委书记
会议由	会议由
艾滋病	艾滋病
牢固树立	牢固树立
就能够	就能够
社会责任	社会责任
比较好	比较好
消費者	消費者
第十六	第十六
董事長	董事長
做出的	做出的
的症状	的症状
行业协会	行业协会
國民黨	國民黨
面对面	面对面
太多了	太多了
诸葛亮	诸葛亮
就是因为	就是因为
宝贵的	宝贵的
城市建设	城市建设
经意间	经意间
微信群	微信群
分析师	分析师
洗干净	洗干净
职业学院	职业学院
在国家	在国家
哈萨克	哈萨克
无疑是	无疑是
研討會	研討會
你觉得	你觉得
自由的	自由的
产品质量	产品质量
市委副书记	市委副书记
出版的	出版的
工作坊	工作坊
团支部	团支部
是我的	是我的
行政机关	行政机关
老人的	老人的
停留在	停留在
各自的	各自的
基础设施建设	基础设施建设
医生的	医生的
最后一个	最后一个
这样看来	这样看来
理论与	理论与
十五条	十五条
也是非常	也是非常
前所未有的	前所未有的
把我们	把我们
通知我们	通知我们
十二月	十二月
可以从	可以从
和社会保障	和社会保障
代表作	代表作
始建于	始建于
让孩子们	让孩子们
不得不说	不得不说
准备工作	准备工作
也有人	也有人
增加值	增加值
工作的通知	工作的通知
仍然是	仍然是
深思熟虑	深思熟虑
庞大的	庞大的
工商联	工商联
会如何	会如何
城镇化	城镇化
制定的	制定的
应用程序	应用程序
理论和	理论和
那样的	那样的
掌握了	掌握了
健康码	健康码
又一个	又一个
作风建设	作风建设
有很大的	有很大的
依然是	依然是
做好了	做好了
予以删除	予以删除
喜欢吃	喜欢吃
文字与	文字与
不断增强	不断增强
的整体	的整体
情况属实	情况属实
专项整治	专项整治
要及时	要及时
什么样	什么样
知识点	知识点
即日起	即日起
优质的	优质的
细胞的	细胞的
电动汽车	电动汽车
原则上	原则上
食用油	食用油
初心使命	初心使命
乳腺癌	乳腺癌
不可或缺	不可或缺
打破了	打破了
解决这个问题	解决这个问题
相关专业	相关专业
卫健委	卫健委
等重点	等重点
中含有	中含有
参观了	参观了
太极拳	太极拳
代表人	代表人
浙江大学	浙江大学
小孩子	小孩子
专家组	专家组
我们有	我们有
的發展	的發展
生产力	生产力
原住民	原住民
的了解	的了解
好朋友	好朋友
同比下降	同比下降
的话语	的话语
本文部分	本文部分
创新的	创新的
肯定会	肯定会
也能够	也能够
完成后	完成后
给人一种	给人一种
我们会第一时间	我们会第一时间
主人公	主人公
氨基酸	氨基酸
共同的	共同的
是一些	是一些
多样的	多样的
实实在	实实在
开发者	开发者
的人来说	的人来说
也希望	也希望
生产总值	生产总值
认真的	认真的
长期以来	长期以来
扎实推进	扎实推进
不利于	不利于
青年教师	青年教师
表示歉意	表示歉意
去医院	去医院
将持续	将持续
还记得	还记得
付出的	付出的
代表性	代表性
代理人	代理人
对你的	对你的
集团的	集团的
项目部	项目部
和经济	和经济
来进行	来进行
鲜明的	鲜明的
开发的	开发的
如果不是	如果不是
带头人	带头人
更多的人	更多的人
开始的	开始的
社会保险	社会保险
文化建设	文化建设
来自于网络	来自于网络
可以直接	可以直接
第十七	第十七
不停地	不停地
的用户	的用户
减少了	减少了
社会各界	社会各界
的好处	的好处
加大对	加大对
智能制造	智能制造
母亲的	母亲的
医务人员	医务人员
积极响应	积极响应
的一系列	的一系列
世界一流	世界一流
组织实施	组织实施
第四届	第四届
污染防治	污染防治
就是为了	就是为了
选择的	选择的
据介绍	据介绍
医疗服务	医疗服务
都能够	都能够
也是如此	也是如此
我们会第一时间予以删除	我们会第一时间予以删除
手中的	手中的
经常会	经常会
那一刻	那一刻
女演员	女演员
可以根据	可以根据
贡献力量	贡献力量
战斗力	战斗力
投资人	投资人
传递更多信息	传递更多信息
凝聚力	凝聚力
臺北市	臺北市
做不到	做不到
我们都知道	我们都知道
错误或	错误或
一个大	一个大
的理由	的理由
了一個	了一個
如何在	如何在
刑事责任	刑事责任
宣传贯彻	宣传贯彻
大面积	大面积
员工的	员工的
导致了	导致了
这些年	这些年
曾经说过	曾经说过
战斗机	战斗机
走出去	走出去
生态系统	生态系统
主持召开	主持召开
的主体	的主体
教育培训	教育培训
职业技能	职业技能
十六条	十六条
网络上	网络上
不仅要	不仅要
全心全	全心全
融媒体	融媒体
民营企业	民营企业
艺术学院	艺术学院
组织和	组织和
比较多	比较多
党的建设	党的建设
台灣的	台灣的
到这里	到这里
为什么会	为什么会
需要在	需要在
的建议	的建议
也越来越	也越来越
与管理	与管理
第十八	第十八
锦标赛	锦标赛
文化和旅游	文化和旅游
所有人都	所有人都
喜爱的	喜爱的
我还是	我还是
最初的	最初的
固定资产	固定资产
做的事	做的事
大家都知道	大家都知道
社会治理	社会治理
也不用	也不用
克里斯	克里斯
了解清楚	了解清楚
活动现场	活动现场
二零一	二零一
第十九	第十九
试用期	试用期
指导意见	指导意见
纳税人	纳税人
我们现在	我们现在
不动产	不动产
同样是	同样是
一站式	一站式
正因为	正因为
的那种	的那种
相关工作	相关工作
的第二	的第二
问题是	问题是
和企业	和企业
的地位	的地位
图片资源	图片资源
奥林匹克	奥林匹克
迎刃而解	迎刃而解
有限的	有限的
中级人民法院	中级人民法院
命名为	命名为
风格的	风格的
二十年	二十年
一直到	一直到
放弃了	放弃了
因此在	因此在
澎湃新闻	澎湃新闻
浓厚的	浓厚的
一如既往	一如既往
满意的	满意的
全面建成	全面建成
参与到	参与到
我发现	我发现
中国人民大学	中国人民大学
管理系统	管理系统
线上线下	线上线下
十七条	十七条
八路军	八路军
独一无	独一无
日夜夜	日夜夜
工程项目	工程项目
角色的	角色的
中发现	中发现
家公司	家公司
现实的	现实的
侵犯了您的	侵犯了您的
巧克力	巧克力
是这样	是这样
日日夜夜	日日夜夜
作品中	作品中
发表于	发表于
第二百	第二百
研究表明	研究表明
认定为	认定为
外观性状	外观性状
计划的	计划的
文字与图片资源	文字与图片资源
是全国	是全国
學年度	學年度
两个维护	两个维护
本文部分文字与图片资源	本文部分文字与图片资源
粤港澳	粤港澳
责任人	责任人
并同时向您	并同时向您
每天都有	每天都有
戴口罩	戴口罩
的动力	的动力
类似的	类似的
你可能	你可能
这两种	这两种
疫情的	疫情的
商品房	商品房
固定的	固定的
至关重要	至关重要
京津冀	京津冀
并且在	并且在
岁以上	岁以上
辖区内	辖区内
党的十八大	党的十八大
今后的	今后的
他指出	他指出
了我们	了我们
目前在	目前在
个月的	个月的
并同时向您表示歉意	并同时向您表示歉意
内蒙古自治区	内蒙古自治区
青岛市	青岛市
水平和	水平和
来源标注	来源标注
新模式	新模式
更加的	更加的
西红柿	西红柿
试验区	试验区
全面落实	全面落实
心脏病	心脏病
直升机	直升机
本文部分文字与图片资源来自于网络	本文部分文字与图片资源来自于网络
都比较	都比较
美国总统	美国总统
眼中的	眼中的
中国文化	中国文化
使用权	使用权
只是在	只是在
目标任务	目标任务
同时还	同时还
报告中	报告中
街道办事处	街道办事处
都不知道	都不知道
来源标注错误或	来源标注错误或
将自己的	将自己的
小时的	小时的
确定了	确定了
新北市	新北市
高层次	高层次
由此可见	由此可见
这对于	这对于
她们的	她们的
规划和	规划和
这是我	这是我
意义上的	意义上的
高质量发展的	高质量发展的
来审视	来审视
的颜色	的颜色
部副部长	部副部长
事业上	事业上
两人的	两人的
蔡英文	蔡英文
家长的	家长的
的革命	的革命
一般认为	一般认为
和学习	和学习
国资委	国资委
纪委书记	纪委书记
不论是	不论是
设计和	设计和
传递更多信息之目的	传递更多信息之目的
你是否	你是否
你需要	你需要
总结的来说	总结的来说
更加重要	更加重要
志愿军	志愿军
引导学生	引导学生
侵犯了您的合法权益	侵犯了您的合法权益
了一段	了一段
第二季	第二季
综合体	综合体
文明城市	文明城市
是一项	是一项
区域的	区域的
紧接着	紧接着
成为中国	成为中国
若有来源标注错误或	若有来源标注错误或
具有重要	具有重要
深化改革	深化改革
但对于	但对于
专业委员会	专业委员会
空间的	空间的
国家和地区	国家和地区
关于印发	关于印发
规章制度	规章制度
看待问题	看待问题
的视频	的视频
一般来讲	一般来讲
身心健康	身心健康
新学期	新学期
脚踏实地	脚踏实地
公共场所	公共场所
等功能	等功能
计划生育	计划生育
身边的人	身边的人
启动仪式	启动仪式
带着这些问题	带着这些问题
分钟左右	分钟左右
物理学	物理学
大使馆	大使馆
业内人士	业内人士
转载此文	转载此文
一次次	一次次
发生后	发生后
学士学位	学士学位
为重点	为重点
政策和	政策和
建设工作	建设工作
十八条	十八条
文物保护单位	文物保护单位
开玩笑	开玩笑
商业模式	商业模式
和完善	和完善
人心的	人心的
人才的	人才的
天主教	天主教
当下的	当下的
类似于	类似于
为代表的	为代表的
成为一名	成为一名
新时代的	新时代的
多媒体	多媒体
解决一切	解决一切
总公司	总公司
来想去	来想去
近距离	近距离
電視劇	電視劇
听取了	听取了
连衣裙	连衣裙
市场份额	市场份额
召开的	召开的
构成了	构成了
主要负责人	主要负责人
很大程度上	很大程度上
的营养	的营养
什么都	什么都
因何而发生	因何而发生
具有良好的	具有良好的
支持下	支持下
故事的	故事的
创业板	创业板
宅基地	宅基地
不可思议	不可思议
大力发展	大力发展
资产阶级	资产阶级
一定能	一定能
的保护	的保护
的质量	的质量
珍贵的	珍贵的
朱元璋	朱元璋
是出于传递更多信息之目的	是出于传递更多信息之目的
最近的	最近的
旅游业	旅游业
未成年	未成年
积极配合	积极配合
知识分子	知识分子
清晰的	清晰的
中国队	中国队
第五届	第五届
生活习惯	生活习惯
公开发	公开发
艺术品	艺术品
抑郁症	抑郁症
游戏的	游戏的
很有可能	很有可能
一些人	一些人
呼和浩特	呼和浩特
是多少	是多少
这几年	这几年
的模式	的模式
讓我們	讓我們
突发事件	突发事件
有任何	有任何
积极参加	积极参加
不好意思	不好意思
陈代谢	陈代谢
说自己	说自己
自媒体	自媒体
信息系统	信息系统
希望通过	希望通过
体系的	体系的
消防救援	消防救援
漫长的	漫长的
社会主义核心价值观	社会主义核心价值观
慎重考虑	慎重考虑
让自己的	让自己的
处处长	处处长
发展改革委	发展改革委
服务于	服务于
应急预案	应急预案
对应的	对应的
智慧和	智慧和
中国家	中国家
此时的	此时的
为学生	为学生
本身就是	本身就是
这几个	这几个
转载此文是出于传递更多信息之目的	转载此文是出于传递更多信息之目的
不属于	不属于
轮融资	轮融资
脱颖而出	脱颖而出
后面的	后面的
有意思	有意思
森林公园	森林公园
的最新	的最新
还包括	还包括
在使用	在使用
工业化	工业化
就成了	就成了
改革发展	改革发展
十九条	十九条
完全可以	完全可以
培训机构	培训机构
的优秀	的优秀
年的时间	年的时间
为一体的	为一体的
来审视一下	来审视一下
会觉得	会觉得
就会有	就会有
好自己的	好自己的
句话说	句话说
如有侵权	如有侵权
是全球	是全球
招聘岗位	招聘岗位
也会有	也会有
有必要	有必要
的创新	的创新
要做好	要做好
即使是这样	即使是这样
经过上述	经过上述
据统计	据统计
是一種	是一種
十九届	十九届
分析了	分析了
热烈的	热烈的
结构性	结构性
你的人	你的人
实实在在	实实在在
究竟为何	究竟为何
包含了	包含了
的母亲	的母亲
的父母	的父母
第一期	第一期
发展到	发展到
我就是	我就是
应该如何实现	应该如何实现
因为我们	因为我们
在其中	在其中
的个人	的个人
匈牙利	匈牙利
黑色的	黑色的
非常重大	非常重大
的数量	的数量
一般人	一般人
站起来	站起来
尽全力	尽全力
倾向于	倾向于
海内外	海内外
今天是	今天是
十分的	十分的
的都是	的都是
市场主体	市场主体
作为一种	作为一种
人民代表大会常务委员会	人民代表大会常务委员会
的新型	的新型
拿到了	拿到了
的一段	的一段
确实是	确实是
执行官	执行官
有问题	有问题
省部级	省部级
会议强调	会议强调
不仅能	不仅能
的因素	的因素
管理人	管理人
要想清楚	要想清楚
的交通	的交通
环境卫生	环境卫生
到底是一种怎么样的存在	到底是一种怎么样的存在
结构的	结构的
目标是	目标是
搅拌均匀	搅拌均匀
绿色发展	绿色发展
经过上述讨论	经过上述讨论
什么呢	什么呢
非常高	非常高
但如果我们	但如果我们
消息称	消息称
也许是	也许是
商务部	商务部
在工作中	在工作中
针对性	针对性
两个人的	两个人的
需要注意	需要注意
就不要	就不要
行政院	行政院
全体会议	全体会议
的压力	的压力
成员国	成员国
这部电影	这部电影
水资源	水资源
省委常委	省委常委
存在于	存在于
使命感	使命感
在整个	在整个
中小学生	中小学生
虽然是	虽然是
月出生	月出生
设置了	设置了
春天的	春天的
发现自己	发现自己
胰岛素	胰岛素
少年的	少年的
可靠性	可靠性
研究者	研究者
是非常非常重要的	是非常非常重要的
享受到	享受到
想知道	想知道
市场经济	市场经济
不断完善	不断完善
官方网站	官方网站
航空航天	航空航天
但实际上	但实际上
比利时	比利时
考虑它	考虑它
领先的	领先的
短时间内	短时间内
准备了	准备了
并进行	并进行
被执行	被执行
也都是	也都是
发行的	发行的
后台留言通知我们	后台留言通知我们
请立即后台留言通知我们	请立即后台留言通知我们
污染物	污染物
资格审查	资格审查
这里是	这里是
资产管理	资产管理
基督徒	基督徒
的条件	的条件
和一个	和一个
经验和	经验和
全心全意	全心全意
发达国家	发达国家
加油站	加油站
工业和信息化	工业和信息化
体育馆	体育馆
吃起来	吃起来
没有办法	没有办法
我个人来说	我个人来说
它可以	它可以
控制在	控制在
教育工作	教育工作
解决一切问题的关键	解决一切问题的关键
就好像	就好像
副省长	副省长
决定的	决定的
要不要	要不要
把这个	把这个
机构和	机构和
出现了的事实	出现了的事实
开工建设	开工建设
实验小学	实验小学
研究发现	研究发现
与美国	与美国
的最高	的最高
阶段性	阶段性
大家一起	大家一起
纪念碑	纪念碑
考虑它出现了的事实	考虑它出现了的事实
不锈钢	不锈钢
需要如何做到	需要如何做到
分析和	分析和
切实把	切实把
服务和	服务和
仍然代表	仍然代表
信息公开	信息公开
的不是	的不是
仅仅是	仅仅是
变得更	变得更
国际合作	国际合作
这段时间	这段时间
又会如何产生	又会如何产生
仍然代表了一定的	仍然代表了一定的
绝大部分	绝大部分
三年级	三年级
先进个人	先进个人
保证金	保证金
不说非常重大	不说非常重大
网友们	网友们
对身体	对身体
行业发展	行业发展
仍然代表了一定的意义	仍然代表了一定的意义
不同意	不同意
变化的	变化的
据报道	据报道
积极主动	积极主动
那个人	那个人
自由贸易	自由贸易
指定的	指定的
也是很	也是很
事物的	事物的
形势下	形势下
第一条	第一条
英格兰	英格兰
财经大学	财经大学
驾驶证	驾驶证
的时刻	的时刻
穆斯林	穆斯林
而成的	而成的
深深的	深深的
正处于	正处于
注册资本	注册资本
和精神	和精神
创业者	创业者
新篇章	新篇章
十一月	十一月
疫情影响	疫情影响
问题的关键究竟为何	问题的关键究竟为何
只剩下	只剩下
的未来	的未来
不妨可以这样	不妨可以这样
市场需求	市场需求
不妨可以这样来想	不妨可以这样来想
进入到	进入到
工作站	工作站
建成后	建成后
的观点	的观点
离退休	离退休
思来想去	思来想去
发现问题	发现问题
中央政治局	中央政治局
都无法	都无法
了一句	了一句
为导向	为导向
添加剂	添加剂
人与人	人与人
无线电	无线电
无私奉献	无私奉献
去年同期	去年同期
相关规定	相关规定
的考生	的考生
加快建设	加快建设
对学生	对学生
与我们	与我们
体现出	体现出
印象深刻	印象深刻
就在于	就在于
为广大	为广大
面对这种	面对这种
无论如何	无论如何
市政协	市政协
引发了	引发了
需要如何写	需要如何写
就不是	就不是
并不是完全	并不是完全
脂肪酸	脂肪酸
将进一步	将进一步
首席执行官	首席执行官
发病率	发病率
你就会	你就会
舍不得	舍不得
政府和	政府和
自然而	自然而
深入贯彻落实	深入贯彻落实
发生了会如何	发生了会如何
角度看待问题	角度看待问题
发生又会如何	发生又会如何
为自己的	为自己的
统一战线	统一战线
生产和	生产和
亿元人民币	亿元人民币
大幅度	大幅度
在这样的	在这样的
推动了	推动了
的建筑	的建筑
投入使用	投入使用
教育学院	教育学院
付出了	付出了
在地上	在地上
妈妈的	妈妈的
他就是	他就是
是美国	是美国
的路上	的路上
的一個	的一個
贫困户	贫困户
这个词	这个词
过多的	过多的
电子信息	电子信息
中心组	中心组
自然保护区	自然保护区
空间站	空间站
族自治县	族自治县
眼前的	眼前的
毫无疑问	毫无疑问
收获了	收获了
阿弥陀	阿弥陀
等各种	等各种
抗美援朝	抗美援朝
考虑考虑	考虑考虑
关节炎	关节炎
很明显	很明显
要认真	要认真
转移到	转移到
见证了	见证了
他没有	他没有
也只有	也只有
年毕业于	年毕业于
从一个更大的	从一个更大的
给出了	给出了
矿物质	矿物质
但如果我们从一个更大的	但如果我们从一个更大的
二手房	二手房
精细化	精细化
青年的	青年的
这似乎是一种	这似乎是一种
的理论	的理论
代表了	代表了
永远不会	永远不会
和安全	和安全
新时代文明实践	新时代文明实践
党的二十大胜利召开	党的二十大胜利召开
爱尔兰	爱尔兰
似乎是一种巧合	似乎是一种巧合
无产阶级	无产阶级
不可避免的事实	不可避免的事实
主义者	主义者
自己也	自己也
端午节	端午节
二年级	二年级
投资的	投资的
老党员	老党员
在社会	在社会
现代化的	现代化的
这似乎是一种不可避免的事实	这似乎是一种不可避免的事实
而言之	而言之
直播间	直播间
典型案例	典型案例
在没有	在没有
大家可以	大家可以
成长为	成长为
科技部	科技部
类专业	类专业
圆满完成	圆满完成
配备了	配备了
世纪的	世纪的
並沒有	並沒有
控制的	控制的
是最好的	是最好的
意识的	意识的
以及对	以及对
团队的	团队的
责任制	责任制
人力资源和社会保障	人力资源和社会保障
碳排放	碳排放
习惯了	习惯了
战争的	战争的
更重要	更重要
隆重举行	隆重举行
情况和	情况和
想象力	想象力
谈恋爱	谈恋爱
饰演的	饰演的
在不同	在不同
以为是	以为是
第一大	第一大
年轻人的	年轻人的
技术与	技术与
事业部	事业部
和政治	和政治
理工学院	理工学院
寝食难安	寝食难安
就这么	就这么
美好生活	美好生活
能看到	能看到
高效的	高效的
也成为	也成为
相关信息	相关信息
飞行员	飞行员
但是我	但是我
抗氧化	抗氧化
每个人都有	每个人都有
积极探索	积极探索
告诉他	告诉他
在当时	在当时
的程度	的程度
法律规定	法律规定
投资基金	投资基金
跨境电商	跨境电商
是不会	是不会
基本法	基本法
错过了	错过了
多样化	多样化
实事求是	实事求是
众多的	众多的
还是有	还是有
秦始皇	秦始皇
国内的	国内的
可能在	可能在
星期六	星期六
执行力	执行力
突出贡献	突出贡献
创造性	创造性
开展的	开展的
更需要	更需要
来之不易	来之不易
要做到	要做到
长期的	长期的
代表性的	代表性的
临床试验	临床试验
的主人	的主人
落到实处	落到实处
企事业单位	企事业单位
的一款	的一款
工商管理	工商管理
行动计划	行动计划
副县长	副县长
职人员	职人员
为推动	为推动
的一名	的一名
不在乎	不在乎
化学品	化学品
在爱情	在爱情
我们已经	我们已经
想办法	想办法
的人文	的人文
龙头企业	龙头企业
经济技术	经济技术
立法會	立法會
应当在	应当在
好好地	好好地
部分地区	部分地区
安全生产工作	安全生产工作
变得越来越	变得越来越
好不好	好不好
微量元素	微量元素
比较大	比较大
甚至还	甚至还
共同富裕	共同富裕
建筑工程	建筑工程
环境和	环境和
法学院	法学院
干辣椒	干辣椒
我们所	我们所
和美国	和美国
社会工作	社会工作
长沙市	长沙市
证券交易所	证券交易所
主题党日活动	主题党日活动
的形成	的形成
等信息	等信息
说的是	说的是
中国大陆	中国大陆
医学会	医学会
思想上	思想上
始终保持	始终保持
抵抗力	抵抗力
的女生	的女生
深度融合	深度融合
集体经济	集体经济
怎么能	怎么能
中山大学	中山大学
体系和	体系和
新产品	新产品
中国在	中国在
怎么说	怎么说
了解更多	了解更多
这首歌	这首歌
对我的意义	对我的意义
为确保	为确保
全面建设社会主义现代化	全面建设社会主义现代化
维吾尔	维吾尔
一直都是	一直都是
艰苦奋斗	艰苦奋斗
司法局	司法局
优惠政策	优惠政策
级别的	级别的
深深地	深深地
使我们	使我们
说实话	说实话
工作队	工作队
与合作	与合作
的科学	的科学
是不能	是不能
优美的	优美的
新华网	新华网
感情的	感情的
可能有	可能有
高性能	高性能
非常好的	非常好的
的一句话	的一句话
婴幼儿	婴幼儿
参谋长	参谋长
也表示	也表示
中国驻	中国驻
什么事	什么事
抗生素	抗生素
服务员	服务员
工业园区	工业园区
的报告	的报告
做生意	做生意
财产安全	财产安全
建立在	建立在
住房公积金	住房公积金
儿子的	儿子的
几乎没有	几乎没有
积极推进	积极推进
在外面	在外面
了这个	了这个
联系我们	联系我们
个项目	个项目
二十五	二十五
高尔夫	高尔夫
社会实践	社会实践
在现场	在现场
游戏中	游戏中
为核心的党中央	为核心的党中央
出了一	出了一
的关注	的关注
的特色	的特色
中国共产党的	中国共产党的
心灵的	心灵的
喜欢你	喜欢你
理解和	理解和
可以把	可以把
正在进行	正在进行
志愿服务活动	志愿服务活动
旅游景区	旅游景区
政务服务	政务服务
行政管理	行政管理
也只能	也只能
消失了	消失了
的运动	的运动
是国内	是国内
也只是	也只是
安全教育	安全教育
甚至在	甚至在
哥伦比亚	哥伦比亚
仅次于	仅次于
六年级	六年级
就有了	就有了
本质上	本质上
其次是	其次是
的一条	的一条
课堂上	课堂上
严格遵守	严格遵守
病患者	病患者
优化营商环境	优化营商环境
而是在	而是在
重要性	重要性
赵丽颖	赵丽颖
创造力	创造力
深入了解	深入了解
市人大常委会	市人大常委会
今年是	今年是
体制机制	体制机制
月参加工作	月参加工作
奥地利	奥地利
但是他	但是他
分布式	分布式
突如其	突如其
最新消息	最新消息
根本上	根本上
的幸福	的幸福
实习生	实习生
中国国际	中国国际
综艺节目	综艺节目
对这个	对这个
知名的	知名的
利益的	利益的
武汉大学	武汉大学
在农村	在农村
税务局	税务局
重要指示	重要指示
群体的	群体的
执法人员	执法人员
生产基地	生产基地
房地产开发	房地产开发
反腐败	反腐败
只要是	只要是
的氛围	的氛围
一个非常尴尬	一个非常尴尬
新的一年	新的一年
新一届	新一届
可以使用	可以使用
上一个	上一个
理性的	理性的
总结了	总结了
极大地	极大地
率达到	率达到
职能部门	职能部门
比较高	比较高
一个非常尴尬的事实	一个非常尴尬的事实
不得不面对一个非常尴尬的事实	不得不面对一个非常尴尬的事实
不小的	不小的
的最后	的最后
的动作	的动作
在路上	在路上
省委书记	省委书记
中表示	中表示
第一家	第一家
以习近平同志	以习近平同志
并不是完全重要	并不是完全重要
了大量	了大量
而这些并不是完全重要	而这些并不是完全重要
自己去	自己去
社区居民	社区居民
要提高	要提高
数据分析	数据分析
困难的抉择	困难的抉择
慎重的考虑考虑	慎重的考虑考虑
更加重要的问题是	更加重要的问题是
因为她	因为她
中国青年	中国青年
务必慎重的考虑考虑	务必慎重的考虑考虑
这部剧	这部剧
最受欢迎	最受欢迎
模式的	模式的
现代农业	现代农业
新生儿	新生儿
小康社会	小康社会
三十年	三十年
这么说	这么说
数字化转型	数字化转型
可以将	可以将
和他们	和他们
现实中	现实中
会造成	会造成
制度改革	制度改革
工作要求	工作要求
走访慰问	走访慰问
庆祝中国共产党成立	庆祝中国共产党成立
服务机构	服务机构
困难的抉择下	困难的抉择下
大概是	大概是
最喜欢	最喜欢
目标的	目标的
颁奖典礼	颁奖典礼
到时候	到时候
也是在	也是在
民進黨	民進黨
原作者	原作者
建立的	建立的
一起来看看	一起来看看
层面的	层面的
技术人员	技术人员
只要有意义	只要有意义
优秀传统文化	优秀传统文化
的特殊	的特殊
自主研发	自主研发
合格的	合格的
和使用	和使用
的背后	的背后
台中市	台中市
就必须慎重考虑	就必须慎重考虑
和我们	和我们
也是经过了	也是经过了
作品展	作品展
规模的	规模的
中国人的	中国人的
国防部	国防部
在微博	在微博
其中一个	其中一个
从来不	从来不
去年的	去年的
工作上	工作上
合作关系	合作关系
教育事业	教育事业
党的领导	党的领导
全会精神	全会精神
而努力	而努力
营业执照	营业执照
可不是	可不是
系列的	系列的
分布在	分布在
工作时间	工作时间
另外一个	另外一个
法律的	法律的
的局面	的局面
五险一金	五险一金
现在是	现在是
作用的	作用的
芝加哥	芝加哥
企业管理	企业管理
早期的	早期的
保护和	保护和
最适合	最适合
等进行	等进行
收录于	收录于
平凡的	平凡的
烟花爆竹	烟花爆竹
第二批	第二批
研究方向	研究方向
法定代表人	法定代表人
自己和	自己和
他们都	他们都
少不了	少不了
经纪人	经纪人
在每个日日夜夜	在每个日日夜夜
也是经过了深思熟虑	也是经过了深思熟虑
在每个日日夜夜思考这个问题	在每个日日夜夜思考这个问题
习近平主席	习近平主席
支气管	支气管
有关事项	有关事项
刘德华	刘德华
我真的	我真的
中央纪委	中央纪委
主要用于	主要用于
激发了	激发了
以下有期徒刑	以下有期徒刑
经营管理	经营管理
年代初	年代初
证明了	证明了
生活和	生活和
要强化	要强化
惊人的	惊人的
有效期	有效期
案件的	案件的
表面上	表面上
怎么会	怎么会
丰富了	丰富了
的心灵	的心灵
领导者	领导者
再生能源	再生能源
版本的	版本的
节目的	节目的
应急处置	应急处置
合作协议	合作协议
党的十九届六	党的十九届六
调整为	调整为
第二大	第二大
正式启动	正式启动
一直没有	一直没有
专家学者	专家学者
的工作中	的工作中
回家的	回家的
现阶段	现阶段
境外输入	境外输入
砥砺前行	砥砺前行
也是有	也是有
重大项目	重大项目
住房和	住房和
出席了	出席了
标志性	标志性
表现在	表现在
为公司	为公司
税务总局	税务总局
检察官	检察官
在我们的	在我们的
路上的	路上的
小心翼翼	小心翼翼
虽然没有	虽然没有
月开始	月开始
政府部门	政府部门
成功举办	成功举办
和家长	和家长
更何况	更何况
对他的	对他的
必须在	必须在
并表示	并表示
想象的	想象的
市场监督管理局	市场监督管理局
博士研究生	博士研究生
说明了	说明了
新鲜的	新鲜的
陌生的	陌生的
年出生	年出生
到目前	到目前
好好的	好好的
是人类	是人类
青海省	青海省
冲突下	冲突下
你应该	你应该
要学会	要学会
但是如果	但是如果
文化部	文化部
設計師	設計師
的区别	的区别
了不起	了不起
可能會	可能會
显示屏	显示屏
所学校	所学校
提到过	提到过
舒适的	舒适的
世界大战	世界大战
是什么意思	是什么意思
解决问题的	解决问题的
不能再	不能再
带孩子	带孩子
项规定	项规定
不稳定	不稳定
这部分	这部分
了一位	了一位
他已经	他已经
一对一	一对一
总是在	总是在
推进会	推进会
期待的	期待的
主题曲	主题曲
心中有	心中有
的伟大	的伟大
生产企业	生产企业
大会堂	大会堂
城乡居民	城乡居民
道路交通安全	道路交通安全
银行业	银行业
学前教育	学前教育
发展有限公司	发展有限公司
不可避免的冲突下	不可避免的冲突下
附属医院	附属医院
總經理	總經理
各族人民	各族人民
太大的	太大的
副总理	副总理
彼此的	彼此的
第一卷	第一卷
可以是	可以是
少先队	少先队
的综合	的综合
越来越大	越来越大
活力的	活力的
是他们	是他们
不足以	不足以
催化剂	催化剂
的人士	的人士
前段时间	前段时间
坚强的	坚强的
的女孩	的女孩
等服务	等服务
接受的	接受的
实现中华民族伟大复兴	实现中华民族伟大复兴
地方的	地方的
也正是	也正是
在台灣	在台灣
都应该	都应该
传统文化的	传统文化的
我们必须解决这个问题	我们必须解决这个问题
中秋节	中秋节
与时俱进	与时俱进
死亡率	死亡率
农业生产	农业生产
集成电路	集成电路
和创新	和创新
不仅有	不仅有
表示感谢	表示感谢
自然科学基金	自然科学基金
治疗的	治疗的
每个人都不得不面对	每个人都不得不面对
关心的	关心的
面对这种问题时	面对这种问题时
突出问题	突出问题
容易被	容易被
每个人都不得不面对这些问题	每个人都不得不面对这些问题
我们还	我们还
就行了	就行了
单位和	单位和
微信号	微信号
期间的	期间的
先进集体	先进集体
实验学校	实验学校
学研究	学研究
中心小学	中心小学
意想不到	意想不到
这都是	这都是
方向盘	方向盘
被害人	被害人
工信部	工信部
保持在	保持在
前几天	前几天
设计与	设计与
地进行	地进行
不同的是	不同的是
不是一个	不是一个
个人防护	个人防护
新闻出版	新闻出版
职业道德	职业道德
听起来	听起来
工程的	工程的
相比于	相比于
范围内的	范围内的
哈萨克斯坦	哈萨克斯坦
发布公告	发布公告
佛山市	佛山市
的時間	的時間
希望在	希望在
发出的	发出的
也已经	也已经
时不时	时不时
的衣服	的衣服
在一些	在一些
在公司	在公司
警示教育	警示教育
的经典	的经典
全国政协	全国政协
儿童的	儿童的
健康管理	健康管理
所以他	所以他
西游记	西游记
研究报告	研究报告
大革命	大革命
有人在	有人在
的中心	的中心
成立以来	成立以来
委员会副主任	委员会副主任
的比赛	的比赛
没有一个	没有一个
被认为是	被认为是
市面上	市面上
发生变化	发生变化
中医药大学	中医药大学
凝心聚力	凝心聚力
先锋模范	先锋模范
自然是	自然是
分辨率	分辨率
的表演	的表演
法律责任	法律责任
科学与技术	科学与技术
高新技术企业	高新技术企业
苏州市	苏州市
国际社会	国际社会
和历史	和历史
理解的	理解的
打造成	打造成
进一步增强	进一步增强
次全国	次全国
让对方	让对方
第一书记	第一书记
文化产业	文化产业
我们从	我们从
把这些	把这些
神经系统	神经系统
都有着	都有着
设立的	设立的
也十分	也十分
等项目	等项目
办主任	办主任
安全事故	安全事故
如果能	如果能
来不及	来不及
小女孩	小女孩
的秘密	的秘密
绝对是	绝对是
的生活方式	的生活方式
的民族	的民族
抓住了问题的关键	抓住了问题的关键
觉得很	觉得很
购物中心	购物中心
一切则会	一切则会
很多事情	很多事情
本科专业	本科专业
一切则会迎刃而解	一切则会迎刃而解
向大家	向大家
比赛的	比赛的
发明专利	发明专利
对这个世界	对这个世界
的女儿	的女儿
奖最佳	奖最佳
中共中央政治局	中共中央政治局
顺利完成	顺利完成
优良传统	优良传统
县委常委	县委常委
着我们	着我们
工作任务	工作任务
的感受	的感受
结果显示	结果显示
展开了	展开了
中华文化	中华文化
数据中心	数据中心
的业务	的业务
我们知道	我们知道
非常大	非常大
完全没有	完全没有
科学发展	科学发展
服务站	服务站
中学生	中学生
的人数	的人数
动车组	动车组
的智慧	的智慧
培养学生	培养学生
绿色的	绿色的
的季节	的季节
将达到	将达到
方方面	方方面
行政法规	行政法规
司令部	司令部
的房子	的房子
意见建议	意见建议
美丽乡村	美丽乡村
物业管理	物业管理
人物的	人物的
第六届	第六届
都是有	都是有
当中的	当中的
心脑血管	心脑血管
但是一	但是一
线城市	线城市
他强调	他强调
地铁站	地铁站
影视剧	影视剧
四个意识	四个意识
和要求	和要求
说不定	说不定
详细了解	详细了解
拥有了	拥有了
和方法	和方法
互联互通	互联互通
迷人的	迷人的
万元以上	万元以上
上发表	上发表
可根据	可根据
就容易	就容易
久而久之	久而久之
到一个	到一个
诉讼法	诉讼法
居委会	居委会
组组长	组组长
主要从事	主要从事
可分为	可分为
观看了	观看了
这辈子	这辈子
我爱你	我爱你
清明节	清明节
攻坚克难	攻坚克难
消费品	消费品
阿弥陀佛	阿弥陀佛
或许是	或许是
扎实开展	扎实开展
出入境	出入境
和相关	和相关
我的心	我的心
崭新的	崭新的
应急管理	应急管理
不断发展	不断发展
同时在	同时在
希望能够	希望能够
老一辈	老一辈
的行动	的行动
坚实基础	坚实基础
公司和	公司和
但没有	但没有
体育场	体育场
于一体的	于一体的
农作物	农作物
收费站	收费站
研究中	研究中
家门口	家门口
攻坚战	攻坚战
还不错	还不错
立德树人	立德树人
经济开发区	经济开发区
帝国主义	帝国主义
几分钟	几分钟
市场监管局	市场监管局
高校毕业生	高校毕业生
独有的	独有的
南京大学	南京大学
膳食纤维	膳食纤维
工作方案	工作方案
有多大	有多大
对社会	对社会
综合治理	综合治理
葡萄糖	葡萄糖
一般是	一般是
也应该	也应该
几乎是	几乎是
实现的	实现的
该怎么	该怎么
不确定性	不确定性
与世界	与世界
科研成果	科研成果
不要再	不要再
卫生部	卫生部
第二名	第二名
的分析	的分析
必要时	必要时
拿出来	拿出来
持续推进	持续推进
在不经意间	在不经意间
有针对	有针对
生命力	生命力
检察长	检察长
工作机制	工作机制
改革创新	改革创新
创作者	创作者
的新闻	的新闻
温馨提示	温馨提示
进一步完善	进一步完善
总觉得	总觉得
实体经济	实体经济
根本没有	根本没有
济南市	济南市
示范基地	示范基地
通过此次	通过此次
卡塔尔	卡塔尔
落实好	落实好
第一個	第一個
让观众	让观众
科技股份有限公司	科技股份有限公司
的全部	的全部
中国人民银行	中国人民银行
做自己	做自己
表面的	表面的
这么多年	这么多年
的趋势	的趋势
上了一	上了一
即使在	即使在
带到了	带到了
拍摄的	拍摄的
今天就	今天就
报名时间	报名时间
回来的	回来的
优秀教师	优秀教师
但还是	但还是
千万别	千万别
也不敢	也不敢
和朋友	和朋友
处理的	处理的
实施的	实施的
关键时刻	关键时刻
妇幼保健	妇幼保健
工程院院士	工程院院士
仪式上	仪式上
淡淡的	淡淡的
大家对	大家对
开放的	开放的
三个方面	三个方面
责任的	责任的
亿美元的	亿美元的
民主生活会	民主生活会
因地制宜	因地制宜
说明书	说明书
的风格	的风格
颁发的	颁发的
阅读原文	阅读原文
努力的	努力的
中国国家	中国国家
广大群众	广大群众
以习近平同志为核心的党中央	以习近平同志为核心的党中央
的出现仍然代表了一定的意义	的出现仍然代表了一定的意义
元左右	元左右
也有很多	也有很多
精美的	精美的
工程专业	工程专业
的到来	的到来
有的是	有的是
聪明的	聪明的
的本质	的本质
在一次	在一次
范冰冰	范冰冰
以后的	以后的
会议要求	会议要求
这种方式	这种方式
微粒贷	微粒贷
全体师生	全体师生
这次的	这次的
的是什么	的是什么
规划建设	规划建设
社区卫生	社区卫生
小提琴	小提琴
战略性	战略性
打开了	打开了
受到影响	受到影响
部分的	部分的
按要求	按要求
现如今	现如今
为抓手	为抓手
关键字	关键字
市场营销	市场营销
方法和	方法和
人员在	人员在
对本人	对本人
坐落于	坐落于
对人体	对人体
双一流	双一流
是我们的	是我们的
另一位	另一位
教科书	教科书
的人格	的人格
粤港澳大湾区	粤港澳大湾区
神秘的	神秘的
语言文字	语言文字
反映出	反映出
毛利率	毛利率
青春期	青春期
张家口	张家口
虽然在	虽然在
吃什么	吃什么
智慧的	智慧的
最后一次	最后一次
红十字会	红十字会
人民出版社	人民出版社
饮用水	饮用水
电影院	电影院
不必要的	不必要的
淋漓尽	淋漓尽
力量的	力量的
各式各	各式各
大酒店	大酒店
大剧院	大剧院
同学们的	同学们的
莫过于	莫过于
国家重点	国家重点
人际关系	人际关系
不完全	不完全
矛盾纠纷	矛盾纠纷
会发生	会发生
工程系	工程系
周围的	周围的
总体规划	总体规划
也是有一定	也是有一定
人为本	人为本
航天员	航天员
总建筑面积	总建筑面积
并提供	并提供
为建设	为建设
复工复产	复工复产
所带来的	所带来的
我只是	我只是
战争中	战争中
从小就	从小就
不出来	不出来
新发展理念	新发展理念
星期五	星期五
一般在	一般在
就是我们	就是我们
节日的	节日的
空气质量	空气质量
但现在	但现在
很多人的	很多人的
科技的	科技的
单纯的	单纯的
被视为	被视为
族自治州	族自治州
核心技术	核心技术
人们在	人们在
准考证	准考证
还不如	还不如
不明白	不明白
短期内	短期内
精神文明	精神文明
教育家	教育家
应急救援	应急救援
体育局	体育局
规模化	规模化
法律服务	法律服务
跟大家	跟大家
资料显示	资料显示
努力学习	努力学习
中西医	中西医
宝宝的	宝宝的
邀请了	邀请了
会引起	会引起
已久的	已久的
是一条	是一条
坚持不懈	坚持不懈
十足的	十足的
财政局	财政局
党和人民	党和人民
在当地	在当地
年轻时	年轻时
理事長	理事長
作曲家	作曲家
主席团	主席团
代言人	代言人
应当按照	应当按照
任务的	任务的
讲解了	讲解了
作为中国	作为中国
就是说	就是说
问题和	问题和
人民为中心	人民为中心
设立了	设立了
几个人	几个人
北京的	北京的
整体的	整体的
世界第一	世界第一
当然是	当然是
管理员	管理员
长大了	长大了
过来的	过来的
中文版	中文版
落实到	落实到
管理条例	管理条例
半个月	半个月
齐心协力	齐心协力
社会学	社会学
之外的	之外的
教研室	教研室
有这么	有这么
保证了	保证了
持之以	持之以
交流合作	交流合作
二十一	二十一
本平台	本平台
相较于	相较于
会发现	会发现
和学生	和学生
特别行政区	特别行政区
还有什么	还有什么
我看到	我看到
具有一定的	具有一定的
了一名	了一名
回到家	回到家
疾控中心	疾控中心
有的时候	有的时候
一时间	一时间
制片人	制片人
满足了	满足了
發展的	發展的
值得我们	值得我们
创建工作	创建工作
一口气	一口气
和研究	和研究
新世纪	新世纪
少先队员	少先队员
迄今为止	迄今为止
文学奖	文学奖
档案馆	档案馆
常住人口	常住人口
教学质量	教学质量
文化中心	文化中心
为目的	为目的
发展新	发展新
波罗蜜	波罗蜜
媒体的	媒体的
应届毕业生	应届毕业生
利物浦	利物浦
的老师	的老师
严格要求	严格要求
所有权	所有权
一定要注意	一定要注意
的决心	的决心
圖片來源	圖片來源
可行性	可行性
接班人	接班人
的商业	的商业
下列情形	下列情形
主任医师	主任医师
第七届	第七届
美術館	美術館
港澳台	港澳台
当选为	当选为
各行各	各行各
开心的	开心的
政府采购	政府采购
的范围	的范围
重要的作用	重要的作用
行政主管部门	行政主管部门
国家标准	国家标准
宣传工作	宣传工作
经济损失	经济损失
的两个	的两个
不到位	不到位
威尼斯	威尼斯
是由于	是由于
的年代	的年代
的这个	的这个
创新能力	创新能力
移动互联网	移动互联网
殖民地	殖民地
湖南卫视	湖南卫视
年龄段	年龄段
教育资源	教育资源
居民的	居民的
的制作	的制作
车型的	车型的
经济效益	经济效益
越來越	越來越
来说意义重大	来说意义重大
澳門特別行政區	澳門特別行政區
的办法	的办法
岗位职责	岗位职责
的成本	的成本
處理器	處理器
在此基础上	在此基础上
夏令营	夏令营
签订了	签订了
深入人心	深入人心
以及在	以及在
部电影	部电影
世界里	世界里
转载自	转载自
现在已经	现在已经
就会被	就会被
发展趋势	发展趋势
的文字	的文字
电子邮件	电子邮件
上海的	上海的
东莞市	东莞市
是一所	是一所
极高的	极高的
研究与	研究与
第四次	第四次
是世界上	是世界上
这个名字	这个名字
银行的	银行的
也算是	也算是
生命中	生命中
中国市场	中国市场
认真落实	认真落实
你就是	你就是
是这样的	是这样的
强调了	强调了
系统性	系统性
中国电影	中国电影
十二年	十二年
关于加强	关于加强
自己所	自己所
修正案	修正案
发展中	发展中
签署了	签署了
可能导致	可能导致
岁的时候	岁的时候
一切的	一切的
小姐姐	小姐姐
开展工作	开展工作
忘记了	忘记了
但是他们	但是他们
产业集群	产业集群
服务体系	服务体系
坚定理想信念	坚定理想信念
不会再	不会再
方式的	方式的
等行业	等行业
电子产品	电子产品
在城市	在城市
进校园	进校园
锂电池	锂电池
的舞台	的舞台
世锦赛	世锦赛
会更加	会更加
收视率	收视率
给别人	给别人
的小说	的小说
介绍一下	介绍一下
为社会	为社会
显示出	显示出
发展方向	发展方向
上市的	上市的
沉浸在	沉浸在
愉快的	愉快的
上新台阶	上新台阶
债权人	债权人
很高兴	很高兴
认识了	认识了
在心里	在心里
奥巴马	奥巴马
中获得	中获得
和世界	和世界
是多么	是多么
物质的	物质的
管理与	管理与
评论区	评论区
而且是	而且是
上的讲话	上的讲话
我们认为	我们认为
大概率	大概率
帮助他们	帮助他们
主要以	主要以
等单位	等单位
确定为	确定为
受不了	受不了
征求意见稿	征求意见稿
也同样	也同样
主办方	主办方
医学科	医学科
自然灾害	自然灾害
免费订阅	免费订阅
国际电影节	国际电影节
不了解	不了解
无限的	无限的
的一般	的一般
这样一来	这样一来
今天我们	今天我们
但是却	但是却
提到了	提到了
的老人	的老人
青春的	青春的
了多少	了多少
前面的	前面的
历史悠久	历史悠久
服务保障	服务保障
的那样	的那样
系统和	系统和
的场景	的场景
也不例外	也不例外
困难和	困难和
在剧中	在剧中
工程施工	工程施工
好不容易	好不容易
防控措施	防控措施
传承红色基因	传承红色基因
持之以恒	持之以恒
文化生活	文化生活
其他国家	其他国家
市场规模	市场规模
共和國	共和國
妻子的	妻子的
也是有一定意义的	也是有一定意义的
文学家	文学家
对这个世界也是有一定意义的	对这个世界也是有一定意义的
事实对本人	事实对本人
事实对本人来说意义重大	事实对本人来说意义重大
並不是	並不是
实施意见	实施意见
下来了	下来了
人性的	人性的
個人資料	個人資料
更适合	更适合
换届选举	换届选举
新华社记者	新华社记者
这么做	这么做
四个自信	四个自信
流行病	流行病
产业结构	产业结构
的手段	的手段
哈哈哈	哈哈哈
该怎么办	该怎么办
县人民政府	县人民政府
如果你的	如果你的
还不够	还不够
希望自己	希望自己
同学的	同学的
现实生活中	现实生活中
并结合	并结合
工作进行	工作进行
内部的	内部的
在任何	在任何
外面的	外面的
尼泊尔	尼泊尔
差异化	差异化
我们党	我们党
天气预报	天气预报
组织召开	组织召开
教育集团	教育集团
向我们	向我们
这里有	这里有
老师在	老师在
曾多次	曾多次
如果要	如果要
忽略了	忽略了
以下是	以下是
准备的	准备的
系统中	系统中
长大后	长大后
再点击	再点击
不及待	不及待
工作开展	工作开展
货币政策	货币政策
我们的生活	我们的生活
随着时间的	随着时间的
请放心	请放心
也不想	也不想
学术交流	学术交流
培养了	培养了
事實上	事實上
都属于	都属于
在家中	在家中
用户提供	用户提供
目前正在	目前正在
但是对于	但是对于
的一家	的一家
贸市场	贸市场
您就可以	您就可以
经济技术开发区	经济技术开发区
自己对	自己对
的唯一	的唯一
福州市	福州市
资源和	资源和
宁波市	宁波市
当他们	当他们
中之重	中之重
山东大学	山东大学
最主要	最主要
切实增强	切实增强
都有一个	都有一个
换句话说	换句话说
职业资格	职业资格
要求和	要求和
系主任	系主任
的那一刻	的那一刻
甚至连	甚至连
成就感	成就感
会成为	会成为
保留了	保留了
创新型	创新型
有需要	有需要
老太太	老太太
学院院长	学院院长
家庭成员	家庭成员
不要太	不要太
十九大	十九大
历史性	历史性
在你的	在你的
来说是	来说是
的处理	的处理
主题教育	主题教育
另一個	另一個
的大门	的大门
创新驱动	创新驱动
建设用地	建设用地
我们不能	我们不能
和家人	和家人
达不到	达不到
还会有	还会有
为孩子	为孩子
公益性	公益性
找一个	找一个
有很大	有很大
清楚地	清楚地
的使命	的使命
在此之前	在此之前
饮食习惯	饮食习惯
人民群众的	人民群众的
地球上	地球上
的高级	的高级
第三代	第三代
考试成绩	考试成绩
违法所得	违法所得
自己的生活	自己的生活
一种是	一种是
冠心病	冠心病
这样的话	这样的话
自己的孩子	自己的孩子
引发的	引发的
这方面	这方面
就会出现	就会出现
为什么不	为什么不
配套设施	配套设施
文化馆	文化馆
这几天	这几天
隶属于	隶属于
中指出	中指出
苏维埃	苏维埃
是什么呢	是什么呢
中医院	中医院
什么的	什么的
非常多	非常多
排名第一	排名第一
的日子里	的日子里
采取了	采取了
领导班子成员	领导班子成员
担当作为	担当作为
严重影响	严重影响
预防和	预防和
科技公司	科技公司
各民族	各民族
经济体	经济体
第一季度	第一季度
人民大会堂	人民大会堂
的结构	的结构
淋漓尽致	淋漓尽致
与国际	与国际
在广州	在广州
病人的	病人的
处理好	处理好
感染的	感染的
工作岗位	工作岗位
半决赛	半决赛
持有的	持有的
章子怡	章子怡
社区的	社区的
历史上的	历史上的
学专业	学专业
的表情	的表情
的计划	的计划
甚至会	甚至会
你没有	你没有
主教练	主教练
表现得	表现得
生物医药	生物医药
的妻子	的妻子
的工具	的工具
记忆力	记忆力
的实际	的实际
生态环境保护	生态环境保护
南宁市	南宁市
爱自己	爱自己
专科学校	专科学校
深入贯彻	深入贯彻
迫不及待	迫不及待
这一生	这一生
转变为	转变为
全面贯彻	全面贯彻
中国画	中国画
所能及	所能及
的成长	的成长
党代会精神	党代会精神
建设中	建设中
的日本	的日本
教学工作	教学工作
的自由	的自由
能做到	能做到
信息安全	信息安全
教科文	教科文
再也没有	再也没有
命运共同体	命运共同体
中国企业	中国企业
履职尽责	履职尽责
的名义	的名义
委员会主席	委员会主席
在这种情况下	在这种情况下
不得已	不得已
演出的	演出的
阅读本文	阅读本文
沈阳市	沈阳市
英特尔	英特尔
相比之下	相比之下
项目管理	项目管理
会选择	会选择
陷入了	陷入了
参加过	参加过
的提升	的提升
政治任务	政治任务
一般情况下	一般情况下
了一点	了一点
蒲公英	蒲公英
永远是	永远是
给了我	给了我
这样说过	这样说过
队伍教育整顿	队伍教育整顿
总承包	总承包
官方微博	官方微博
隐患排查	隐患排查
公共文化	公共文化
公司与	公司与
了一张	了一张
清洗干净	清洗干净
不相同	不相同
先进单位	先进单位
哪怕是	哪怕是
音乐的	音乐的
坐落在	坐落在
自贸区	自贸区
上下功夫	上下功夫
日常工作	日常工作
管理层	管理层
的歌曲	的歌曲
密切接触	密切接触
目前已经	目前已经
积极分子	积极分子
会遇到	会遇到
内容和	内容和
原来是	原来是
总的来说	总的来说
当然了	当然了
的评价	的评价
本科学	本科学
核武器	核武器
学科建设	学科建设
坚实的基础	坚实的基础
的收入	的收入
团队合作	团队合作
加强与	加强与
先点击	先点击
望远镜	望远镜
实力的	实力的
恢复正常	恢复正常
在进行	在进行
孙悟空	孙悟空
等原因	等原因
个城市	个城市
方向的	方向的
玩游戏	玩游戏
积累了	积累了
才会有	才会有
有名的	有名的
大屠杀	大屠杀
二十八	二十八
和教育	和教育
短暂的	短暂的
党风廉政建设	党风廉政建设
增加到	增加到
处罚金	处罚金
一切都是	一切都是
美国政府	美国政府
有機會	有機會
政法大学	政法大学
瞩目的	瞩目的
的经营	的经营
营养价值	营养价值
招生简章	招生简章
一个问题	一个问题
来临之际	来临之际
的一个重要	的一个重要
奢侈品	奢侈品
中心和	中心和
较多的	较多的
谢霆锋	谢霆锋
美好生活的	美好生活的
占据了	占据了
增长率	增长率
怎么看	怎么看
公益活动	公益活动
一小时	一小时
产学研	产学研
然后在	然后在
的眼睛	的眼睛
自来水	自来水
行政長官	行政長官
制作人	制作人
具体情况	具体情况
住房和城乡建设	住房和城乡建设
党的十八大以来	党的十八大以来
工作的重要	工作的重要
西方国家	西方国家
市场竞争	市场竞争
意见和建议	意见和建议
让你的	让你的
大力推进	大力推进
不合理	不合理
中新社	中新社
同志们	同志们
更多地	更多地
的画面	的画面
等各类	等各类
疫情防控和	疫情防控和
的道理	的道理
人员进行	人员进行
的正确	的正确
第二款	第二款
施工现场	施工现场
沟通能力	沟通能力
是一样的	是一样的
尤其在	尤其在
正式成立	正式成立
旅游景点	旅游景点
创造出	创造出
精益求精	精益求精
促进会	促进会
的高速	的高速
网约车	网约车
市教育局	市教育局
各乡镇	各乡镇
俄羅斯	俄羅斯
的天空	的天空
讲故事	讲故事
明确规定	明确规定
融媒体中心	融媒体中心
都不敢	都不敢
广大党员干部	广大党员干部
主要由	主要由
并提出	并提出
医疗保障	医疗保障
凭借着	凭借着
的带领下	的带领下
帮助我们	帮助我们
给出的	给出的
突如其来的	突如其来的
只能在	只能在
中国传统	中国传统
自然而然	自然而然
企业文化	企业文化
生活质量	生活质量
年輕人	年輕人
认为自己	认为自己
食品药品	食品药品
更喜欢	更喜欢
积极作用	积极作用
要进一步	要进一步
为单位	为单位
并及时	并及时
最容易	最容易
阿联酋	阿联酋
如果你想	如果你想
前不久	前不久
很长时间	很长时间
的信心	的信心
史上最	史上最
希望你	希望你
老龄化	老龄化
主要领导	主要领导
人员和	人员和
基础知识	基础知识
不影响	不影响
将通过	将通过
可再生能源	可再生能源
合肥市	合肥市
回头看	回头看
在面对	在面对
收入的	收入的
对我们的	对我们的
这样您就可以	这样您就可以
等重要	等重要
这其中	这其中
什么叫	什么叫
月加入中国共产党	月加入中国共产党
第二条	第二条
政府工作报告	政府工作报告
的现实	的现实
请您先点击	请您先点击
可用于	可用于
老人家	老人家
音乐剧	音乐剧
在去年	在去年
的一半	的一半
記者會	記者會
化管理	化管理
的水平	的水平
习近平在	习近平在
随着年龄	随着年龄
年成立	年成立
准确把握	准确把握
工作情况	工作情况
增长了	增长了
的共同	的共同
集团董事长	集团董事长
至今日	至今日
对公司	对公司
融入到	融入到
打招呼	打招呼
请大家	请大家
国有资产	国有资产
要保持	要保持
富有哲理	富有哲理
并获得	并获得
我当时	我当时
理论上	理论上
了一套	了一套
有两种	有两种
都喜欢	都喜欢
城际铁路	城际铁路
增长的	增长的
方方面面	方方面面
是否存在	是否存在
研究生院	研究生院
建筑师	建筑师
每個人	每個人
的表达	的表达
制度和	制度和
指明了	指明了
知道的	知道的
仅供参考	仅供参考
馬來西亞	馬來西亞
张艺谋	张艺谋
就如同	就如同
让别人	让别人
中心城市	中心城市
规划设计	规划设计
到医院	到医院
包括了	包括了
可以为	可以为
的英雄	的英雄
关键技术	关键技术
第二年	第二年
管理规定	管理规定
服务商	服务商
郭德纲	郭德纲
殊不知	殊不知
参加活动	参加活动
个月内	个月内
学校和	学校和
的材料	的材料
违法违规	违法违规
过一个	过一个
交通工具	交通工具
一度的	一度的
实际的	实际的
先锋模范作用	先锋模范作用
的研发	的研发
关于开展	关于开展
旅游局	旅游局
最大化	最大化
的各项	的各项
等诸多	等诸多
阅读本文前	阅读本文前
井冈山	井冈山
抑制剂	抑制剂
高素质	高素质
支部书记	支部书记
基因组	基因组
拒绝了	拒绝了
在不经意间这样说过	在不经意间这样说过
违纪违法	违纪违法
天然的	天然的
我不想	我不想
居住在	居住在
经济带	经济带
雌激素	雌激素
的危害	的危害
因为有	因为有
朝阳区	朝阳区
高速铁路	高速铁路
不相信	不相信
专门的	专门的
生活垃圾	生活垃圾
的交流	的交流
一般都是	一般都是
建筑设计	建筑设计
亚运会	亚运会
纪念日	纪念日
不用担心	不用担心
城市群	城市群
没关系	没关系
的小朋友	的小朋友
可靠的	可靠的
最快的	最快的
咨询服务	咨询服务
国际贸易	国际贸易
政治上	政治上
不正当	不正当
出版物	出版物
科技大學	科技大學
经历的	经历的
办公楼	办公楼
危险的	危险的
宣传片	宣传片
版权所有	版权所有
转基因	转基因
敌人的	敌人的
拉开了	拉开了
这样说	这样说
人社局	人社局
支持的	支持的
是什麼	是什麼
进程中	进程中
在校生	在校生
大大的	大大的
作家协会	作家协会
学习成绩	学习成绩
管理等	管理等
骨质疏松	骨质疏松
健身房	健身房
我们能	我们能
监护人	监护人
强有力的	强有力的
完整性	完整性
第二期	第二期
世纪初	世纪初
你现在	你现在
的公告	的公告
这似乎	这似乎
被执行人	被执行人
力所能及	力所能及
多层次	多层次
所高校	所高校
适合自己的	适合自己的
及周边	及周边
有这样的	有这样的
教学中	教学中
成员单位	成员单位
服务质量	服务质量
地看着	地看着
智慧城市	智慧城市
基金的	基金的
更应该	更应该
统一到	统一到
生长发育	生长发育
元宵节	元宵节
洋溢着	洋溢着
走下去	走下去
起源于	起源于
驾驶人	驾驶人
在一起的	在一起的
在中国的	在中国的
痛苦的	痛苦的
相互作用	相互作用
进行分析	进行分析
使他们	使他们
请您先点击上面的	请您先点击上面的
二十二	二十二
周杰伦	周杰伦
一级学科	一级学科
新陈代谢	新陈代谢
内容包括	内容包括
少年儿童	少年儿童
翻炒均匀	翻炒均匀
你必须	你必须
和组织	和组织
的大量	的大量
不具备	不具备
帮助孩子	帮助孩子
曾经提到过	曾经提到过
古建筑	古建筑
出生在	出生在
希望的	希望的
工作计划	工作计划
金融科技	金融科技
供给侧	供给侧
尼西亚	尼西亚
语言文学	语言文学
动物园	动物园
在孩子	在孩子
上海交通大学	上海交通大学
工作部署	工作部署
清洁能源	清洁能源
承载着	承载着
肯定的	肯定的
所以他们	所以他们
在日常	在日常
活动在	活动在
珠三角	珠三角
伙伴关系	伙伴关系
依法追究	依法追究
的美国	的美国
会增加	会增加
利用率	利用率
符合条件的	符合条件的
什么事情	什么事情
真正做到	真正做到
本人的	本人的
经济学家	经济学家
是无法	是无法
拼多多	拼多多
新局面	新局面
从根本上	从根本上
科研项目	科研项目
广播电视台	广播电视台
不了的	不了的
马斯克	马斯克
三分之一	三分之一
十年的	十年的
任何事情	任何事情
鄂尔多	鄂尔多
工业互联网	工业互联网
富有哲理的话	富有哲理的话
的操作	的操作
但不能	但不能
优秀奖	优秀奖
本场比赛	本场比赛
表达能力	表达能力
自己的力量	自己的力量
日晚上	日晚上
新浪微博	新浪微博
全球的	全球的
是不可	是不可
微信支付	微信支付
工作中的	工作中的
不一致	不一致
恢复了	恢复了
与他人	与他人
台南市	台南市
的领导	的领导
工作效率	工作效率
第二步	第二步
老人们	老人们
而我们	而我们
颜色的	颜色的
钓鱼岛	钓鱼岛
辛亥革命	辛亥革命
认真贯彻落实	认真贯彻落实
低收入	低收入
死亡的	死亡的
长大的	长大的
的青年	的青年
很重要的	很重要的
低成本	低成本
多少人	多少人
对我来说	对我来说
密切关注	密切关注
紧密结合	紧密结合
益生菌	益生菌
高等院校	高等院校
聯合國	聯合國
成一个	成一个
时间段	时间段
工作地点	工作地点
和地方	和地方
可以去	可以去
俄罗斯的	俄罗斯的
说过一句富有哲理的话	说过一句富有哲理的话
国土资源	国土资源
名学生	名学生
乡村振兴战略	乡村振兴战略
报名表	报名表
一步一步	一步一步
迎接党的二十大胜利召开	迎接党的二十大胜利召开
关系到	关系到
而得名	而得名
的主要原因	的主要原因
教学楼	教学楼
来形容	来形容
面积约	面积约
非常适合	非常适合
交易日	交易日
自己做	自己做
听到了	听到了
华尔街	华尔街
影片中	影片中
国家机关	国家机关
这样您就可以继续	这样您就可以继续
病毒的	病毒的
切实提高	切实提高
在欧洲	在欧洲
的造型	的造型
说出来	说出来
文化与	文化与
没必要	没必要
多小时	多小时
崇高的	崇高的
营造了	营造了
训练营	训练营
学术论文	学术论文
艺术节	艺术节
行政审批	行政审批
沟通交流	沟通交流
能力提升	能力提升
的限制	的限制
一直都	一直都
影响着	影响着
党的百年	党的百年
养成良好的	养成良好的
采访时表示	采访时表示
合理安排	合理安排
留守儿童	留守儿童
四年级	四年级
人士的	人士的
蓝色的	蓝色的
爱奇艺	爱奇艺
每小时	每小时
兴趣爱好	兴趣爱好
了一大	了一大
双方的	双方的
发挥作用	发挥作用
不久前	不久前
新兴产业	新兴产业
鄂尔多斯	鄂尔多斯
丝毫不	丝毫不
大多是	大多是
的姿态	的姿态
象征着	象征着
工作实际	工作实际
到来的	到来的
就是你	就是你
的人在	的人在
合作办学	合作办学
给我的	给我的
请注明	请注明
公司将	公司将
亿元的	亿元的
糖尿病患者	糖尿病患者
中长期	中长期
为主体	为主体
对企业	对企业
准确的	准确的
新京报	新京报
癌细胞	癌细胞
可以使	可以使
在她的	在她的
课题组	课题组
的能量	的能量
工业企业	工业企业
对这些	对这些
常务理事	常务理事
具有重要意义	具有重要意义
沉浸式	沉浸式
出现问题	出现问题
自古以来	自古以来
认真负责	认真负责
世界经济	世界经济
三年的	三年的
招生计划	招生计划
分子的	分子的
但是我们	但是我们
有这样	有这样
让人们	让人们
责任担当	责任担当
度假区	度假区
息息相关	息息相关
看似简单	看似简单
临床医学	临床医学
文章来源	文章来源
学习宣传贯彻	学习宣传贯彻
价格上涨	价格上涨
而现在	而现在
身体状况	身体状况
性问题	性问题
清楚的	清楚的
主要负责	主要负责
十二五	十二五
经济区	经济区
级地震	级地震
干事创业	干事创业
如果想	如果想
全面建成小康社会	全面建成小康社会
另行通知	另行通知
音乐节	音乐节
的理想	的理想
落实情况	落实情况
著名的话	著名的话
文件精神	文件精神
增添了	增添了
全国的	全国的
自信心	自信心
全国人大常委会	全国人大常委会
打造了	打造了
到底是什么	到底是什么
县委副书记	县委副书记
三角形	三角形
公安厅	公安厅
的危险	的危险
有以下	有以下
给学生	给学生
国务院办公厅	国务院办公厅
产品和	产品和
接触到	接触到
书法家	书法家
机械化	机械化
为主线	为主线
人的生活	人的生活
在国外	在国外
的地区	的地区
走到了	走到了
不接受	不接受
生孩子	生孩子
的看法	的看法
是因為	是因為
但不限	但不限
不良反应	不良反应
做好准备	做好准备
刑事案件	刑事案件
单位和个人	单位和个人
与他们	与他们
和行动	和行动
的控制	的控制
幸福生活	幸福生活
出入口	出入口
动画片	动画片
是怎样	是怎样
有更多	有更多
委员会的	委员会的
服务工作	服务工作
是否能	是否能
管理学	管理学
安全工作	安全工作
性生活	性生活
对孩子的	对孩子的
可怕的	可怕的
男演员	男演员
最大功率	最大功率
史研究	史研究
的人类	的人类
小伙伴们	小伙伴们
主要为	主要为
第二十	第二十
劳动关系	劳动关系
美术家协会	美术家协会
提高到	提高到
阐述了	阐述了
自己的人生	自己的人生
请放心关注	请放心关注
正式开始	正式开始
中华民族的	中华民族的
并不多	并不多
毫不犹豫	毫不犹豫
传达了	传达了
总成绩	总成绩
引领作用	引领作用
了一件	了一件
报告显示	报告显示
交叉口	交叉口
汽车的	汽车的
燃料电池	燃料电池
在日常生活中	在日常生活中
可想而知	可想而知
红领巾	红领巾
干部群众	干部群众
比上年增长	比上年增长
克萨斯	克萨斯
好吃的	好吃的
几年的	几年的
的青春	的青春
有兴趣	有兴趣
结婚了	结婚了
高跟鞋	高跟鞋
的星座	的星座
追溯到	追溯到
基础教育	基础教育
约定的	约定的
不仅在	不仅在
专升本	专升本
价格为	价格为
总是会	总是会
不得超过	不得超过
涉及的	涉及的
他们将	他们将
连云港	连云港
更进一步	更进一步
的创作	的创作
精神病	精神病
全国人民	全国人民
自己的想法	自己的想法
全面建设社会主义现代化国家	全面建设社会主义现代化国家
代表队	代表队
理解为	理解为
目标和	目标和
第一季	第一季
竞争力的	竞争力的
始终把	始终把
和法律	和法律
的联系	的联系
电商平台	电商平台
通过的	通过的
并根据	并根据
的人工	的人工
的自己	的自己
项目中	项目中
交流会	交流会
其主要	其主要
在深圳	在深圳
发展成为	发展成为
中药材	中药材
一大批	一大批
可直接	可直接
应及时	应及时
遭到了	遭到了
会展中心	会展中心
有所不同	有所不同
上下游	上下游
秘书处	秘书处
通常是	通常是
退休人员	退休人员
必要性	必要性
说的话	说的话
还不是	还不是
各地的	各地的
的追求	的追求
介绍说	介绍说
与应用	与应用
因为这个	因为这个
应注意	应注意
等多项	等多项
神奇的	神奇的
还能够	还能够
所做的	所做的
主营业务	主营业务
进行全面	进行全面
在英国	在英国
说过一句著名的话	说过一句著名的话
认识的	认识的
各领域	各领域
的意识	的意识
第一种	第一种
必不可少的	必不可少的
好奇心	好奇心
委员长	委员长
的宣传	的宣传
解决的	解决的
服务有限公司	服务有限公司
的外观	的外观
出不穷	出不穷
在这场	在这场
豐富的	豐富的
这些东西	这些东西
中国和	中国和
又是一	又是一
播出的	播出的
真实性	真实性
以优异成绩	以优异成绩
指导和	指导和
分钟的	分钟的
管理机构	管理机构
不包括	不包括
停下来	停下来
在很多	在很多
看了看	看了看
的特征	的特征
个人资料	个人资料
统筹推进	统筹推进
风景名胜	风景名胜
结构和	结构和
范围的	范围的
保持了	保持了
的学校	的学校
的成果	的成果
的機會	的機會
蓬勃发展	蓬勃发展
切实做好	切实做好
咨询电话	咨询电话
下面就	下面就
充满着	充满着
紀錄片	紀錄片
中心城区	中心城区
最好不要	最好不要
革命先烈	革命先烈
本科及以上学历	本科及以上学历
战场上	战场上
的实力	的实力
三季度	三季度
年全球	年全球
月以来	月以来
共享单车	共享单车
科学学院	科学学院
在里面	在里面
最小的	最小的
的措施	的措施
的网络	的网络
的影響	的影響
資料庫	資料庫
的道路上	的道路上
星期日	星期日
涵盖了	涵盖了
錦標賽	錦標賽
广西壮族	广西壮族
的影响力	的影响力
发脾气	发脾气
默默地	默默地
统战部	统战部
交易中心	交易中心
校友会	校友会
广大市民	广大市民
提质增效	提质增效
随处可见	随处可见
过了一	过了一
各方面的	各方面的
也随之	也随之
創辦人	創辦人
虽然说	虽然说
表彰大会	表彰大会
第三名	第三名
被发现	被发现
这个过程	这个过程
为代表	为代表
的居民	的居民
高风险地区	高风险地区
预期的	预期的
运载火箭	运载火箭
的一部	的一部
第二种	第二种
营养物质	营养物质
工作会议精神	工作会议精神
成功地	成功地
厦门市	厦门市
前一天	前一天
行政区划	行政区划
反过来	反过来
恶性肿瘤	恶性肿瘤
有不同的	有不同的
電視台	電視台
旗舰店	旗舰店
是完全	是完全
美味的	美味的
地中海	地中海
会议指出	会议指出
交易的	交易的
但随着	但随着
商业化	商业化
實驗室	實驗室
责任和	责任和
无所谓	无所谓
的区域	的区域
音樂會	音樂會
层出不穷	层出不穷
的职业	的职业
航站楼	航站楼
不值得	不值得
张柏芝	张柏芝
每一步	每一步
生长的	生长的
文化活动	文化活动
社会发展	社会发展
看一下	看一下
所需要的	所需要的
措并举	措并举
从来不会	从来不会
大学和	大学和
沃尔沃	沃尔沃
生肖蛇	生肖蛇
调查研究	调查研究
状态下	状态下
哲学家	哲学家
的情景	的情景
的平均	的平均
人人都	人人都
我开始	我开始
中国移动	中国移动
昆明市	昆明市
生肖兔	生肖兔
资源共享	资源共享
學生的	學生的
师生的	师生的
年代末	年代末
政府在	政府在
突破了	突破了
加密货币	加密货币
党组副书记	党组副书记
旁边的	旁边的
一点都不	一点都不
签约仪式	签约仪式
完全是免费订阅	完全是免费订阅
准确性	准确性
大熊猫	大熊猫
的一员	的一员
莫名其	莫名其
庆祝建党	庆祝建党
到哪里	到哪里
围绕着	围绕着
表现的	表现的
最好是	最好是
杰出的	杰出的
控制系统	控制系统
生态文明建设	生态文明建设
全媒体	全媒体
我感觉	我感觉
需要注意的是	需要注意的是
但因为	但因为
是日本	是日本
证明材料	证明材料
南北朝	南北朝
垃圾桶	垃圾桶
運動員	運動員
的一场	的一场
等措施	等措施
余万元	余万元
非常大的	非常大的
保护好	保护好
找工作	找工作
版权归	版权归
时间是	时间是
以上就是	以上就是
成交量	成交量
第八届	第八届
听说过	听说过
的那个	的那个
专题讲座	专题讲座
实施细则	实施细则
广西壮族自治区	广西壮族自治区
本职工作	本职工作
国家一级	国家一级
执行董事	执行董事
道路交通	道路交通
第二章	第二章
一点也不	一点也不
億美元	億美元
拉开帷幕	拉开帷幕
与企业	与企业
有意义	有意义
相關的	相關的
圆满结束	圆满结束
被授予	被授予
也逐渐	也逐渐
只知道	只知道
在其他	在其他
农贸市场	农贸市场
工作总结	工作总结
年下半年	年下半年
的时候就	的时候就
在经济	在经济
一百年	一百年
也包括	也包括
监管部门	监管部门
承诺书	承诺书
中西医结合	中西医结合
结晶体	结晶体
莎士比亚	莎士比亚
不能够	不能够
我也是	我也是
座谈会上	座谈会上
批准的	批准的
设备和	设备和
一点的	一点的
到自己	到自己
更新的	更新的
经营的	经营的
中西部	中西部
人来说	人来说
也有了	也有了
为客户提供	为客户提供
不公平	不公平
星期一	星期一
能够让	能够让
中國大陸	中國大陸
积极推动	积极推动
综合实力	综合实力
这个地方	这个地方
喜迎二十大	喜迎二十大
控制器	控制器
義大利	義大利
大学毕业	大学毕业
有序推进	有序推进
打下了	打下了
相关人员	相关人员
基本功	基本功
发展中国家	发展中国家
世界卫生	世界卫生
年获得	年获得
的高校	的高校
高中生	高中生
最佳的	最佳的
玩手机	玩手机
根据自己的	根据自己的
副处长	副处长
是一片	是一片
营业部	营业部
了一眼	了一眼
桃園市	桃園市
都是由	都是由
政策措施	政策措施
组织领导	组织领导
绿水青山	绿水青山
药物治疗	药物治疗
党总支书记	党总支书记
斯大林	斯大林
扎实做好	扎实做好
抗击疫情	抗击疫情
哲学社会科学	哲学社会科学
生动的	生动的
与自己	与自己
潜意识	潜意识
的水果	的水果
安全意识	安全意识
出來的	出來的
日中午	日中午
政治协商	政治协商
彰显了	彰显了
我以为	我以为
依旧是	依旧是
至少有	至少有
区委书记	区委书记
的时间内	的时间内
红色文化	红色文化
這就是	這就是
年平均	年平均
的一座	的一座
的记忆	的记忆
钢结构	钢结构
保健品	保健品
款车型	款车型
同事们	同事们
林业局	林业局
兄弟姐妹	兄弟姐妹
沒想到	沒想到
就业创业	就业创业
与环境	与环境
打交道	打交道
奧斯卡	奧斯卡
市场中	市场中
有几个	有几个
应聘人员	应聘人员
也很难	也很难
向中国	向中国
全国重点	全国重点
医学观察	医学观察
实质性	实质性
的利益	的利益
全民健身	全民健身
平方千米	平方千米
教育学	教育学
等技术	等技术
越来越高	越来越高
在新的	在新的
在疫情	在疫情
标准和	标准和
第一课	第一课
五年级	五年级
出发点	出发点
实用性	实用性
欢声笑语	欢声笑语
名副其实	名副其实
热水器	热水器
大学教授	大学教授
國家的	國家的
政治部	政治部
功能性	功能性
土地上	土地上
是否会	是否会
国家自然科学基金	国家自然科学基金
村民们	村民们
安全稳定	安全稳定
的那些	的那些
全体教师	全体教师
温州市	温州市
的脚步	的脚步
国家战略	国家战略
核心期刊	核心期刊
权力的	权力的
取消了	取消了
透明的	透明的
中央党校	中央党校
大自然的	大自然的
工程有限公司	工程有限公司
的课程	的课程
特殊情况	特殊情况
一本书	一本书
反而是	反而是
大多數	大多數
乡村旅游	乡村旅游
工作安排	工作安排
是香港	是香港
优秀人才	优秀人才
最关键	最关键
什么都不	什么都不
思想认识	思想认识
第三季度	第三季度
这是我们	这是我们
科学与工程	科学与工程
资源优势	资源优势
万千瓦	万千瓦
环境影响	环境影响
成功了	成功了
方法的	方法的
精彩回顾	精彩回顾
对未来	对未来
都觉得	都觉得
北京师范大学	北京师范大学
点点滴滴	点点滴滴
投融资	投融资
如果我	如果我
膝关节	膝关节
的大部分	的大部分
并不意味着	并不意味着
史上的	史上的
传达学习	传达学习
中国社会科学院	中国社会科学院
交通枢纽	交通枢纽
和专业	和专业
等专业	等专业
宣传资料	宣传资料
最高法院	最高法院
高级中学	高级中学
来实现	来实现
其中之一	其中之一
看电影	看电影
发生过	发生过
科学研究院	科学研究院
不知所	不知所
各个方面	各个方面
铁路局	铁路局
集中的	集中的
服务水平	服务水平
自己想要	自己想要
不是说	不是说
可行的	可行的
游泳池	游泳池
爱上了	爱上了
建筑业	建筑业
日晚间	日晚间
文件的	文件的
参赛选手	参赛选手
民政局	民政局
这些都	这些都
我和我的	我和我的
第三条	第三条
精致的	精致的
营造出	营造出
基本情况	基本情况
教育孩子	教育孩子
提供商	提供商
靠自己	靠自己
服务区	服务区
办公软件	办公软件
主题为	主题为
潜移默	潜移默
在我看来	在我看来
让人觉得	让人觉得
金融危机	金融危机
受害人	受害人
心里的	心里的
的主角	的主角
走过的	走过的
产业园区	产业园区
视觉效果	视觉效果
先生在	先生在
参与的	参与的
海淀区	海淀区
的开发	的开发
为保障	为保障
必须是	必须是
多大的	多大的
我心里	我心里
的思考	的思考
你是不是	你是不是
副理事长	副理事长
会让你	会让你
等其他	等其他
简直是	简直是
中国铁路	中国铁路
国家公园	国家公园
提醒大家	提醒大家
年春节	年春节
的笑容	的笑容
不断扩大	不断扩大
快速增长	快速增长
到目前为止	到目前为止
故宫博物院	故宫博物院
情人节	情人节
正式发布	正式发布
加强了	加强了
实施了	实施了
职业学校	职业学校
高度评价	高度评价
每天都有分享	每天都有分享
第一代	第一代
第二轮	第二轮
民主主义	民主主义
十几年	十几年
大大小	大大小
消化道	消化道
的歷史	的歷史
表达对	表达对
而这个	而这个
本次会议	本次会议
出版了	出版了
的主力	的主力
浮想联翩	浮想联翩
活动和	活动和
的全球	的全球
哪一个	哪一个
打造出	打造出
现金流	现金流
而这种	而这种
免费的	免费的
的祝福	的祝福
组织了	组织了
十八届	十八届
新四军	新四军
生命安全	生命安全
继续保持	继续保持
式建筑	式建筑
教师们	教师们
自己的人	自己的人
无障碍	无障碍
是他的	是他的
亲朋好友	亲朋好友
怎么可能	怎么可能
进行了深入	进行了深入
的色彩	的色彩
示意图	示意图
民主党派	民主党派
项目经理	项目经理
信息和	信息和
展览会	展览会
持有人	持有人
没有被	没有被
为了避免	为了避免
独一无二的	独一无二的
本单位	本单位
检查组	检查组
现场的	现场的
计划在	计划在
有一颗	有一颗
最喜欢的	最喜欢的
遗憾的是	遗憾的是
养老服务	养老服务
只能是	只能是
的学术	的学术
的快乐	的快乐
的步伐	的步伐
查看更多	查看更多
人群中	人群中
在今天	在今天
在那个	在那个
国家发改委	国家发改委
法西斯	法西斯
经济发展的	经济发展的
生态保护	生态保护
雷锋精神	雷锋精神
年年底	年年底
情节严重的	情节严重的
周星驰	周星驰
广播电台	广播电台
特别好	特别好
学习能力	学习能力
核心竞争力	核心竞争力
提供一个	提供一个
研究机构	研究机构
经济建设	经济建设
老年人的	老年人的
八项规定	八项规定
全产业链	全产业链
和社会发展	和社会发展
反垄断	反垄断
工业园	工业园
委书记	委书记
将迎来	将迎来
蒙古族	蒙古族
这个小	这个小
浓厚氛围	浓厚氛围
问题导向	问题导向
关于进一步	关于进一步
冷空气	冷空气
设计了	设计了
前行的	前行的
文章了	文章了
诠释了	诠释了
广泛关注	广泛关注
项目和	项目和
团队成员	团队成员
联席会议	联席会议
是如此	是如此
真人秀	真人秀
科创板	科创板
铝合金	铝合金
十一届	十一届
不平衡	不平衡
和人民	和人民
并要求	并要求
扫黑除恶	扫黑除恶
资料图	资料图
中国内地	中国内地
免疫系统	免疫系统
在这方面	在这方面
退役军人事务	退役军人事务
与现代	与现代
文学作品	文学作品
尽量避免	尽量避免
自我保护	自我保护
婚姻的	婚姻的
报告会	报告会
相当的	相当的
沉重的	沉重的
质量管理	质量管理
年至今	年至今
茅台酒	茅台酒
中央政府	中央政府
是一个非常	是一个非常
本条例	本条例
的品质	的品质
诺基亚	诺基亚
遇到困难	遇到困难
的眼神	的眼神
自然会	自然会
赋予了	赋予了
绝对不会	绝对不会
也更加	也更加
的战斗	的战斗
之中的	之中的
于一体	于一体
民族文化	民族文化
的朋友们	的朋友们
村里的	村里的
武则天	武则天
的另一	的另一
镇政府	镇政府
我不会	我不会
副区长	副区长
功能障碍	功能障碍
任何时候	任何时候
有一段	有一段
死亡病例	死亡病例
与文化	与文化
了一家	了一家
吞吐量	吞吐量
完全不	完全不
日发布	日发布
消防员	消防员
网上报名	网上报名
第三章	第三章
中的应用	中的应用
面向社会	面向社会
审判决	审判决
有效性	有效性
笑着说	笑着说
近现代	近现代
在此期间	在此期间
是属于	是属于
的强大	的强大
避免了	避免了
是根据	是根据
黄晓明	黄晓明
为人民服务	为人民服务
的气质	的气质
岗位要求	岗位要求
今日头条	今日头条
也有着	也有着
管理处	管理处
教育系统	教育系统
创造的	创造的
日子里	日子里
本身就	本身就
特点是	特点是
不方便	不方便
投资有限公司	投资有限公司
毕业证	毕业证
没那么	没那么
才有了	才有了
的资金	的资金
碳达峰	碳达峰
有很好的	有很好的
具有较强的	具有较强的
勇往直	勇往直
女生的	女生的
民族团结进步	民族团结进步
在行动	在行动
洗衣机	洗衣机
特別是	特別是
迈克尔	迈克尔
或多或少	或多或少
生活上	生活上
司法机关	司法机关
本科学历	本科学历
法律援助	法律援助
快速的	快速的
我们先	我们先
等地的	等地的
有时间	有时间
基层治理	基层治理
重中之重	重中之重
临床上	临床上
他希望	他希望
因此而	因此而
正所谓	正所谓
只是为了	只是为了
爷爷奶奶	爷爷奶奶
一個人	一個人
还存在	还存在
协同发展	协同发展
长时间的	长时间的
世界中	世界中
提交的	提交的
确立了	确立了
绝不会	绝不会
财务管理	财务管理
新业态	新业态
全体员工	全体员工
高质量的	高质量的
有一条	有一条
可以做	可以做
服务等	服务等
正是在	正是在
这说明	这说明
就觉得	就觉得
小微企业	小微企业
失败的	失败的
年时间	年时间
有多么	有多么
都是一个	都是一个
妇幼保健院	妇幼保健院
发出了	发出了
的地步	的地步
要按照	要按照
建议大家	建议大家
以确保	以确保
金字塔	金字塔
。。。。	。。。。
不禁让人	不禁让人
健康状况	健康状况
在今后	在今后
对于我们	对于我们
开奖结果	开奖结果
碳水化合物	碳水化合物
房间里	房间里
爱你的	爱你的
安全防范	安全防范
采用的是	采用的是
的小孩	的小孩
本年度	本年度
电子版	电子版
直接的	直接的
相关政策	相关政策
多岁的	多岁的
它就是	它就是
坚持下去	坚持下去
負責人	負責人
怎么回事	怎么回事
的时间里	的时间里
这一个	这一个
两部分	两部分
再也不	再也不
岁月的	岁月的
平日里	平日里
不断加强	不断加强
周岁以下	周岁以下
受访者	受访者
绿色低碳	绿色低碳
等特点	等特点
研究工作	研究工作
与大家	与大家
总人口	总人口
预告片	预告片
体育运动	体育运动
分别在	分别在
小说的	小说的
安全保障	安全保障
团组织	团组织
多一些	多一些
就是把	就是把
交通便利	交通便利
巴勒斯坦	巴勒斯坦
中汲取	中汲取
看起來	看起來
因为没有	因为没有
这样可以	这样可以
世界级	世界级
传承人	传承人
学期的	学期的
行政村	行政村
数字货币	数字货币
进行检查	进行检查
普通高中	普通高中
网络诈骗	网络诈骗
都有自己的	都有自己的
究竟是	究竟是
五中全会精神	五中全会精神
工作需要	工作需要
写字楼	写字楼
和别人	和别人
等重大	等重大
一流的	一流的
见到了	见到了
受益匪浅	受益匪浅
已经有了	已经有了
对象的	对象的
食物的	食物的
世界各国	世界各国
大力弘扬	大力弘扬
悠久的	悠久的
我公司	我公司
接地气	接地气
讲话精神	讲话精神
含有丰富的	含有丰富的
国务院关于	国务院关于
实用的	实用的
下一次	下一次
从一开始	从一开始
自主创新	自主创新
研究所所长	研究所所长
你喜欢	你喜欢
不断创新	不断创新
投标人	投标人
每天的	每天的
一分钟	一分钟
了一声	了一声
等一批	等一批
编辑部	编辑部
建设单位	建设单位
简直就是	简直就是
依法治	依法治
网格员	网格员
体育锻炼	体育锻炼
重点任务	重点任务
由国家	由国家
分享的	分享的
豆瓣酱	豆瓣酱
主体的	主体的
旧金山	旧金山
的方式来	的方式来
主要是因为	主要是因为
这样您就可以继续免费	这样您就可以继续免费
倒计时	倒计时
的作者	的作者
蓝色字体	蓝色字体
因斯坦	因斯坦
国庆节	国庆节
去看看	去看看
归属于	归属于
近年來	近年來
销售的	销售的
一路上	一路上
中青年	中青年
安全风险	安全风险
生物技术	生物技术
发展与	发展与
构成的	构成的
在一定程度上	在一定程度上
多措并举	多措并举
有很多人	有很多人
三部曲	三部曲
關鍵字	關鍵字
房地产市场	房地产市场
方式和	方式和
的独特	的独特
的行业	的行业
向他们	向他们
条件和	条件和
第二代	第二代
长长的	长长的
的目光	的目光
密切相关	密切相关
形体油画	形体油画
以此来	以此来
宫颈癌	宫颈癌
浓浓的	浓浓的
与会人员	与会人员
帮助你	帮助你
我们自己	我们自己
这样一句话	这样一句话
副组长	副组长
局限于	局限于
慢性病	慢性病
生物多样性	生物多样性
严厉打击	严厉打击
日出生于	日出生于
推荐的	推荐的
散发着	散发着
肾功能	肾功能
集团军	集团军
治疗方法	治疗方法
知识竞赛	知识竞赛
陪同下	陪同下
没有那么	没有那么
各地区	各地区
给你们	给你们
耶和华	耶和华
跟我说	跟我说
本项目	本项目
的开始	的开始
最终的	最终的
把握好	把握好
抓落实	抓落实
社会上	社会上
哈哈哈哈	哈哈哈哈
二手车	二手车
集中隔离	集中隔离
采访中	采访中
素质教育	素质教育
我们看到	我们看到
万余人	万余人
不住了	不住了
负面影响	负面影响
我非常	我非常
角度看	角度看
备忘录	备忘录
电视机	电视机
民族复兴	民族复兴
新时期	新时期
年的历史	年的历史
动人的	动人的
给对方	给对方
可以达到	可以达到
维也纳	维也纳
这里面	这里面
优异的成绩	优异的成绩
的勇气	的勇气
坚实的	坚实的
数量的	数量的
无反顾	无反顾
防灾减灾	防灾减灾
紫外线	紫外线
我们把	我们把
疫情防控措施	疫情防控措施
这只是	这只是
也有一些	也有一些
很长一段时间	很长一段时间
行政区域	行政区域
普通高等学校	普通高等学校
切入点	切入点
听党话	听党话
经济与	经济与
为什么呢	为什么呢
有那么	有那么
大部分人	大部分人
明确提出	明确提出
自己的努力	自己的努力
高峰论坛	高峰论坛
坚持把	坚持把
与国家	与国家
人生中	人生中
走上了	走上了
深刻认识	深刻认识
国外的	国外的
履行职责	履行职责
为一个	为一个
购房者	购房者
交响乐团	交响乐团
最常见的	最常见的
未来发展	未来发展
不错的选择	不错的选择
脱贫攻坚成果	脱贫攻坚成果
天生的	天生的
硕士生	硕士生
国民政府	国民政府
想到了	想到了
申请表	申请表
和谐的	和谐的
的含义	的含义
上班族	上班族
停車場	停車場
心血管疾病	心血管疾病
在这个过程中	在这个过程中
想起了	想起了
都是以	都是以
魅力的	魅力的
开放式	开放式
就是不	就是不
阳光下	阳光下
工作人員	工作人員
还有一种	还有一种
近两年	近两年
一件事情	一件事情
实施办法	实施办法
斯里兰卡	斯里兰卡
发挥着	发挥着
是基于	是基于
分支机构	分支机构
才开始	才开始
的任何	的任何
空气中	空气中
预示着	预示着
湿地公园	湿地公园
我也不	我也不
的手机	的手机
多元化的	多元化的
其实在	其实在
而导致	而导致
含有的	含有的
骨子里	骨子里
给人的	给人的
身体素质	身体素质
钱学森	钱学森
发挥好	发挥好
形象的	形象的
植物园	植物园
搜索引擎	搜索引擎
做事情	做事情
我不能	我不能
用自己	用自己
高层次人才	高层次人才
宣讲团	宣讲团
实际控制	实际控制
和实践	和实践
稳步推进	稳步推进
就一直	就一直
骨干教师	骨干教师
对我说	对我说
是你的	是你的
了一起	了一起
客运站	客运站
的案件	的案件
型企业	型企业
走进了	走进了
有良好的	有良好的
中国与	中国与
半个小时	半个小时
交朋友	交朋友
登记表	登记表
的新冠	的新冠
部署要求	部署要求
印度尼西亚	印度尼西亚
文化自信	文化自信
中國的	中國的
我们希望	我们希望
的新时代	的新时代
研发中心	研发中心
福利待遇	福利待遇
依赖于	依赖于
先后在	先后在
的概率	的概率
实际上是	实际上是
就是这个	就是这个
才不会	才不会
网站上	网站上
学雷锋	学雷锋
规模以上	规模以上
丰富多彩的	丰富多彩的
境内的	境内的
太原市	太原市
大幅提升	大幅提升
是怎么回事	是怎么回事
或以上	或以上
静静地	静静地
发表论文	发表论文
相对来说	相对来说
的交易	的交易
探测器	探测器
子宫内膜	子宫内膜
不懂得	不懂得
孟加拉	孟加拉
等国家	等国家
这座城市	这座城市
既可以	既可以
的人也	的人也
的生长	的生长
市场上的	市场上的
坚守岗位	坚守岗位
管理水平	管理水平
家长会	家长会
的报道	的报道
的有关	的有关
认真地	认真地
出现过	出现过
美国和	美国和
能得到	能得到
英国的	英国的
就会发现	就会发现
爱岗敬业	爱岗敬业
还是非常	还是非常
不同程度的	不同程度的
因为这	因为这
工作时	工作时
工伤保险	工伤保险
在海外	在海外
平时的	平时的
学术界	学术界
揭示了	揭示了
改变的	改变的
为祖国	为祖国
加入到	加入到
欢迎大家	欢迎大家
嘉年华	嘉年华
曾国藩	曾国藩
乘风破浪	乘风破浪
的费用	的费用
请注意	请注意
研究领域	研究领域
营养成分	营养成分
中饰演	中饰演
学习中	学习中
同时又	同时又
向世界	向世界
信息服务	信息服务
更深入	更深入
的解释	的解释
义无反顾	义无反顾
为促进	为促进
的巨大	的巨大
脑海里	脑海里
天花板	天花板
关于做好	关于做好
沟通协调	沟通协调
的象征	的象征
将这些	将这些
我记得	我记得
与众不同	与众不同
妇产科	妇产科
时间表	时间表
自然界	自然界
四川大学	四川大学
按照国家	按照国家
有更多的	有更多的
消化不良	消化不良
当地人	当地人
行动起来	行动起来
都是为了	都是为了
的希望	的希望
年上海	年上海
伊斯兰教	伊斯兰教
也沒有	也沒有
年秋季	年秋季
的首要	的首要
的高端	的高端
负面情绪	负面情绪
每一個	每一個
转型的	转型的
如下图	如下图
国际关系	国际关系
各级党组织	各级党组织
好看的	好看的
专项资金	专项资金
生产生活	生产生活
思想和行动	思想和行动
指导员	指导员
本網站	本網站
等人的	等人的
了一遍	了一遍
的日常	的日常
越来越少	越来越少
都是非常	都是非常
二零零	二零零
核心区	核心区
甚至有	甚至有
无处不在	无处不在
一開始	一開始
万余元	万余元
張專輯	張專輯
视频中	视频中
军人的	军人的
更多关于	更多关于
三十六	三十六
把他们	把他们
而不能	而不能
主动性	主动性
学员们	学员们
的一方	的一方
防护服	防护服
结合实际	结合实际
顺利进行	顺利进行
的帮助	的帮助
睡不着	睡不着
一把手	一把手
以往的	以往的
创新中心	创新中心
专业人士	专业人士
政协副主席	政协副主席
价值和	价值和
成就了	成就了
充分认识	充分认识
容易出现	容易出现
的还是	的还是
无人驾驶	无人驾驶
两年的	两年的
元素的	元素的
疾病预防	疾病预防
一天的	一天的
理论知识	理论知识
助学金	助学金
香港人	香港人
中文系	中文系
持续提升	持续提升
工作委员会	工作委员会
以更加	以更加
白皮书	白皮书
不开心	不开心
发展为	发展为
那时的	那时的
这是个	这是个
周年之际	周年之际
按照规定	按照规定
老旧小区	老旧小区
党的十九届六中全会精神	党的十九届六中全会精神
怎么了	怎么了
也知道	也知道
从中国	从中国
你不能	你不能
更年期	更年期
杂志社	杂志社
相适应	相适应
申请书	申请书
是什么样的	是什么样的
等相关专业	等相关专业
但这些	但这些
巡视员	巡视员
我们去	我们去
可以向	可以向
教授的	教授的
哈佛大学	哈佛大学
基金经理	基金经理
从这里	从这里
和改进	和改进
认定的	认定的
以人为本	以人为本
的一幕	的一幕
三是要	三是要
信息网	信息网
创建于	创建于
月上旬	月上旬
的信念	的信念
粉丝们	粉丝们
要继续	要继续
服务能力	服务能力
不定期	不定期
苏格兰	苏格兰
心目中的	心目中的
无尽的	无尽的
凭什么	凭什么
协调发展	协调发展
告诉大家	告诉大家
折不扣	折不扣
碧桂园	碧桂园
中华人民共和国成立	中华人民共和国成立
提供更	提供更
的印象	的印象
所有人的	所有人的
这段感情	这段感情
也是最	也是最
同志的	同志的
公开发行	公开发行
地质灾害	地质灾害
文化传播	文化传播
自己的情绪	自己的情绪
也一样	也一样
候選人	候選人
文化节	文化节
不那么	不那么
多万元	多万元
座城市	座城市
恨不得	恨不得
男性的	男性的
你已经	你已经
第四章	第四章
所产生的	所产生的
新发展格局	新发展格局
诊断为	诊断为
违反了	违反了
这款车的	这款车的
赵本山	赵本山
尽量不要	尽量不要
极强的	极强的
的正常	的正常
厦门大学	厦门大学
专题学习	专题学习
农业部	农业部
帶來的	帶來的
请不要	请不要
行业内	行业内
指挥中心	指挥中心
爱一个人	爱一个人
包括但不限	包括但不限
一线的	一线的
